"","GEOID","year","tech","info","prof","per","total"
"1",90001,2005,48,5,43,0.61,7898
"2",90002,2005,24,0,24,2.1,1142
"3",90003,2005,68,0,68,1.56,4352
"4",90004,2005,845,422,423,11.96,7064
"5",90005,2005,507,304,203,11.95,4244
"6",90006,2005,422,33,389,4.56,9257
"7",90007,2005,768,84,684,5.45,14082
"8",90008,2005,191,124,67,6.18,3093
"9",90009,2005,0,0,0,0,4692
"10",90010,2005,6131,1454,4677,19.71,31110
"11",90011,2005,98,41,57,0.99,9886
"12",90012,2005,5691,4550,1141,2.25,252941
"13",90013,2005,1113,96,1017,8.41,13228
"14",90014,2005,568,56,512,3.83,14835
"15",90015,2005,1539,895,644,4.29,35880
"16",90016,2005,596,321,275,6.77,8799
"17",90017,2005,13579,1983,11596,35.49,38264
"18",90018,2005,175,11,164,4.57,3826
"19",90019,2005,400,64,336,7.67,5218
"20",90020,2005,185,58,127,1.54,12038
"21",90021,2005,698,0,698,2.55,27377
"22",90022,2005,434,166,268,2.53,17136
"23",90023,2005,396,7,389,1.55,25514
"24",90024,2005,3172,1052,2120,7.13,44519
"25",90025,2005,8409,2871,5538,28.48,29528
"26",90026,2005,430,212,218,7.3,5892
"27",90027,2005,3622,3340,282,16.55,21883
"28",90028,2005,5902,4290,1612,27.1,21781
"29",90029,2005,192,115,77,3.71,5174
"30",90030,2005,0,0,0,0,270
"31",90031,2005,297,0,297,3.23,9183
"32",90032,2005,0,0,0,0,6004
"33",90033,2005,420,0,420,2.3,18264
"34",90034,2005,1205,346,859,13.96,8631
"35",90035,2005,3100,2618,482,24.12,12853
"36",90036,2005,10164,5522,4642,38.45,26432
"37",90037,2005,192,0,192,3.21,5989
"38",90038,2005,7008,6155,853,47.28,14822
"39",90039,2005,580,44,536,5.89,9844
"40",90040,2005,2324,443,1881,5.15,45148
"41",90041,2005,337,0,337,5.82,5787
"42",90042,2005,114,14,100,3.96,2878
"43",90043,2005,36,0,36,1.12,3225
"44",90044,2005,110,62,48,3.9,2820
"45",90045,2005,5153,2811,2342,7.59,67869
"46",90046,2005,1347,559,788,11.07,12172
"47",90047,2005,63,38,25,1.57,4019
"48",90048,2005,3997,1932,2065,12,33322
"49",90049,2005,6868,0,6868,28.99,23689
"50",90050,2005,0,0,0,0,3
"51",90051,2005,13,0,13,2.56,508
"52",90052,2005,0,0,0,0,122
"53",90053,2005,0,0,0,NA,0
"54",90054,2005,0,0,0,0,500
"55",90055,2005,0,0,0,0,52
"56",90056,2005,759,43,716,21.98,3453
"57",90057,2005,703,45,658,7.13,9866
"58",90058,2005,731,88,643,1.68,43526
"59",90059,2005,16,0,16,0.39,4130
"60",90060,2005,0,0,0,0,64
"61",90061,2005,117,0,117,1.83,6392
"62",90062,2005,26,0,26,1.67,1558
"63",90063,2005,115,41,74,2.89,3974
"64",90064,2005,11495,2395,9100,43.14,26646
"65",90065,2005,605,405,200,7.12,8495
"66",90066,2005,3577,736,2841,29.07,12303
"67",90067,2005,10361,2391,7970,38.73,26753
"68",90068,2005,1030,644,386,26.59,3873
"69",90069,2005,2239,693,1546,13.39,16725
"70",90070,2005,0,0,0,0,157
"71",90071,2005,11664,208,11456,35.56,32803
"72",90072,2005,0,0,0,0,61
"73",90073,2005,0,0,0,0,4293
"74",90075,2005,0,0,0,0,8
"75",90076,2005,0,0,0,0,5
"76",90077,2005,99,38,61,4.13,2397
"77",90078,2005,0,0,0,0,40
"78",90079,2005,96,0,96,7.81,1229
"79",90080,2005,0,0,0,0,340
"80",90082,2005,0,0,0,0,5
"81",90083,2005,0,0,0,0,3
"82",90086,2005,93,0,93,6.19,1503
"83",90087,2005,0,0,0,0,4
"84",90089,2005,0,0,0,0,20195
"85",90091,2005,0,0,0,0,13
"86",90094,2005,0,0,0,0,86
"87",90095,2005,181,0,181,2.32,7817
"88",90201,2005,298,119,179,1.87,15927
"89",90202,2005,0,0,0,0,51
"90",90209,2005,12,12,0,1.88,637
"91",90210,2005,2438,1084,1354,12.45,19578
"92",90211,2005,1865,1037,828,18.27,10210
"93",90212,2005,2428,385,2043,17.18,14132
"94",90213,2005,0,0,0,0,151
"95",90220,2005,1194,108,1086,5.36,22285
"96",90221,2005,279,75,204,2.03,13717
"97",90222,2005,0,0,0,0,2854
"98",90224,2005,0,0,0,0,397
"99",90230,2005,2408,620,1788,11.47,20987
"100",90231,2005,0,0,0,0,7872
"101",90232,2005,1884,667,1217,13.07,14419
"102",90233,2005,0,0,0,0,10
"103",90239,2005,0,0,0,0,85
"104",90240,2005,195,0,195,3.45,5652
"105",90241,2005,1088,295,793,6.19,17568
"106",90242,2005,657,0,657,7.41,8865
"107",90245,2005,13642,3130,10512,24.26,56231
"108",90247,2005,209,97,112,1.54,13590
"109",90248,2005,2358,544,1814,6.48,36390
"110",90249,2005,119,9,110,1.16,10241
"111",90250,2005,441,109,332,2.31,19119
"112",90251,2005,0,0,0,0,204
"113",90254,2005,461,128,333,8.38,5498
"114",90255,2005,135,135,0,1.15,11772
"115",90260,2005,227,4,223,3.95,5744
"116",90261,2005,0,0,0,0,78
"117",90262,2005,60,0,60,0.67,8905
"118",90263,2005,0,0,0,0,2744
"119",90264,2005,0,0,0,0,9
"120",90265,2005,1309,375,934,17.84,7338
"121",90266,2005,1787,480,1307,12.35,14466
"122",90267,2005,0,0,0,0,19
"123",90270,2005,55,0,55,1.78,3087
"124",90272,2005,604,102,502,14.21,4251
"125",90274,2005,606,235,371,7.98,7598
"126",90275,2005,336,4,332,11.38,2952
"127",90277,2005,562,165,397,5.75,9772
"128",90278,2005,999,195,804,6.01,16609
"129",90280,2005,237,0,237,1.36,17445
"130",90290,2005,109,42,67,11.23,971
"131",90291,2005,1392,362,1030,21.14,6586
"132",90292,2005,2283,471,1812,18.6,12271
"133",90293,2005,274,18,256,26.05,1052
"134",90294,2005,0,0,0,0,43
"135",90295,2005,0,0,0,0,1
"136",90301,2005,261,81,180,1.88,13913
"137",90302,2005,82,0,82,2.03,4045
"138",90303,2005,40,40,0,0.91,4419
"139",90304,2005,0,0,0,0,3367
"140",90305,2005,0,0,0,0,909
"141",90306,2005,0,0,0,0,154
"142",90307,2005,0,0,0,0,11
"143",90308,2005,0,0,0,0,14
"144",90309,2005,0,0,0,0,6
"145",90310,2005,0,0,0,0,11
"146",90311,2005,0,0,0,0,7
"147",90312,2005,0,0,0,0,18
"148",90401,2005,3954,1421,2533,17.01,23249
"149",90402,2005,153,40,113,11.05,1385
"150",90403,2005,968,272,696,12.37,7827
"151",90404,2005,9116,5206,3910,35.42,25734
"152",90405,2005,3202,811,2391,19.96,16045
"153",90406,2005,0,0,0,0,42
"154",90407,2005,0,0,0,0,1019
"155",90408,2005,0,0,0,0,155
"156",90409,2005,0,0,0,0,8
"157",90410,2005,0,0,0,0,125
"158",90501,2005,3044,618,2426,11.32,26881
"159",90502,2005,513,0,513,4.25,12082
"160",90503,2005,2513,453,2060,8.4,29914
"161",90504,2005,374,57,317,3.63,10297
"162",90505,2005,2702,717,1985,8.79,30745
"163",90506,2005,0,0,0,0,1127
"164",90507,2005,0,0,0,0,91
"165",90508,2005,0,0,0,0,35
"166",90509,2005,33,0,33,0.55,5986
"167",90510,2005,0,0,0,0,88
"168",90601,2005,220,24,196,2.06,10671
"169",90602,2005,918,15,903,11.72,7830
"170",90603,2005,183,8,175,2.4,7629
"171",90604,2005,202,0,202,8.96,2254
"172",90605,2005,258,24,234,3.33,7754
"173",90606,2005,177,26,151,2.98,5949
"174",90607,2005,0,0,0,0,322
"175",90608,2005,0,0,0,0,2266
"176",90609,2005,0,0,0,0,3
"177",90610,2005,0,0,0,0,25
"178",90623,2005,106,0,106,1.97,5388
"179",90630,2005,2326,482,1844,10.8,21536
"180",90631,2005,348,100,248,2.23,15571
"181",90637,2005,0,0,0,0,286
"182",90638,2005,643,87,556,3.35,19173
"183",90639,2005,0,0,0,0,100
"184",90640,2005,460,130,330,2.07,22198
"185",90650,2005,591,242,349,2.69,21951
"186",90651,2005,0,0,0,0,125
"187",90652,2005,0,0,0,0,4
"188",90660,2005,250,20,230,1.83,13636
"189",90661,2005,0,0,0,0,43
"190",90662,2005,0,0,0,0,10
"191",90670,2005,1732,392,1340,3.11,55619
"192",90671,2005,0,0,0,0,1
"193",90701,2005,1747,263,1484,11.78,14836
"194",90702,2005,4,0,4,0.57,703
"195",90703,2005,2544,875,1669,9.22,27588
"196",90704,2005,0,0,0,0,2492
"197",90706,2005,585,355,230,4.21,13909
"198",90707,2005,0,0,0,0,114
"199",90710,2005,135,9,126,1.94,6971
"200",90711,2005,0,0,0,0,37
"201",90712,2005,440,291,149,3.17,13892
"202",90713,2005,37,0,37,1.08,3437
"203",90714,2005,0,0,0,0,1149
"204",90715,2005,11,0,11,1.31,837
"205",90716,2005,5,0,5,0.16,3211
"206",90717,2005,133,34,99,4.44,2995
"207",90723,2005,410,84,326,2.6,15775
"208",90731,2005,624,77,547,5.54,11254
"209",90732,2005,148,0,148,5.1,2902
"210",90733,2005,0,0,0,0,334
"211",90734,2005,0,0,0,0,17
"212",90744,2005,78,18,60,0.81,9654
"213",90745,2005,527,225,302,3.47,15189
"214",90746,2005,979,574,405,7.92,12360
"215",90747,2005,0,0,0,0,1814
"216",90748,2005,0,0,0,0,581
"217",90749,2005,0,0,0,0,1107
"218",90755,2005,549,49,500,9.26,5929
"219",90801,2005,31,0,31,0.27,11391
"220",90802,2005,3330,876,2454,10.18,32705
"221",90803,2005,599,146,453,6.97,8591
"222",90804,2005,513,18,495,6.17,8314
"223",90805,2005,269,74,195,2.52,10657
"224",90806,2005,889,47,842,5.17,17198
"225",90807,2005,1116,249,867,8.13,13733
"226",90808,2005,606,408,198,7.87,7701
"227",90809,2005,0,0,0,0,56
"228",90810,2005,1371,0,1371,6.63,20675
"229",90813,2005,217,0,217,2.06,10542
"230",90814,2005,59,16,43,4.31,1368
"231",90815,2005,361,0,361,3.29,10982
"232",90822,2005,89,0,89,14.02,635
"233",90831,2005,471,221,250,31.19,1510
"234",90832,2005,0,0,0,0,14
"235",90835,2005,0,0,0,0,82
"236",90840,2005,0,0,0,0,4924
"237",90846,2005,182,0,182,1.98,9198
"238",91001,2005,399,161,238,12.6,3166
"239",91003,2005,0,0,0,0,16
"240",91006,2005,1002,173,829,7.98,12564
"241",91007,2005,772,129,643,7.11,10863
"242",91008,2005,0,0,0,0,3
"243",91009,2005,0,0,0,0,414
"244",91010,2005,1122,0,1122,11.88,9445
"245",91011,2005,360,112,248,6.45,5583
"246",91012,2005,0,0,0,0,8
"247",91016,2005,2196,570,1626,12.8,17158
"248",91017,2005,0,0,0,0,275
"249",91020,2005,163,44,119,6.93,2353
"250",91021,2005,0,0,0,0,37
"251",91024,2005,99,8,91,6.88,1439
"252",91025,2005,0,0,0,0,22
"253",91030,2005,665,45,620,9.07,7328
"254",91040,2005,198,72,126,9.21,2151
"255",91041,2005,0,0,0,0,28
"256",91042,2005,170,88,82,9.11,1867
"257",91043,2005,0,0,0,0,36
"258",91046,2005,0,0,0,0,38
"259",91066,2005,0,0,0,0,204
"260",91077,2005,0,0,0,0,24
"261",91101,2005,4557,473,4084,15.84,28762
"262",91102,2005,0,0,0,0,164
"263",91103,2005,791,0,791,9.13,8667
"264",91104,2005,185,41,144,5.65,3275
"265",91105,2005,1208,0,1208,7.27,16614
"266",91106,2005,923,278,645,11.86,7781
"267",91107,2005,2138,955,1183,12.62,16935
"268",91108,2005,233,0,233,7.12,3274
"269",91109,2005,0,0,0,0,13337
"270",91114,2005,0,0,0,0,1
"271",91115,2005,0,0,0,0,22
"272",91116,2005,0,0,0,0,11
"273",91117,2005,0,0,0,0,15
"274",91118,2005,0,0,0,0,1
"275",91125,2005,0,0,0,0,5245
"276",91201,2005,1797,1467,330,14.81,12135
"277",91202,2005,364,16,348,9.72,3745
"278",91203,2005,3639,577,3062,18.84,19318
"279",91204,2005,1083,690,393,7.24,14967
"280",91205,2005,1094,309,785,14.43,7583
"281",91206,2005,656,30,626,7.84,8368
"282",91207,2005,113,5,108,14.3,790
"283",91208,2005,191,25,166,4.35,4390
"284",91209,2005,0,0,0,0,845
"285",91210,2005,199,0,199,4.79,4152
"286",91214,2005,291,102,189,6.77,4297
"287",91221,2005,0,0,0,0,695
"288",91222,2005,0,0,0,0,9
"289",91224,2005,0,0,0,0,18
"290",91225,2005,0,0,0,0,163
"291",91226,2005,0,0,0,0,1
"292",91301,2005,2458,825,1633,17.7,13890
"293",91302,2005,2810,875,1935,16.36,17172
"294",91303,2005,709,200,509,5.84,12149
"295",91304,2005,770,190,580,4.72,16330
"296",91305,2005,0,0,0,0,223
"297",91306,2005,117,0,117,3.47,3376
"298",91307,2005,140,24,116,2.2,6373
"299",91308,2005,0,0,0,0,19
"300",91309,2005,0,0,0,0,421
"301",91310,2005,0,0,0,0,97
"302",91311,2005,3770,1396,2374,9.49,39706
"303",91313,2005,0,0,0,0,380
"304",91316,2005,943,348,595,11.07,8518
"305",91321,2005,380,125,255,4.05,9376
"306",91322,2005,0,0,0,0,428
"307",91324,2005,719,145,574,3.76,19142
"308",91325,2005,242,60,182,3.99,6071
"309",91326,2005,324,47,277,10.49,3090
"310",91327,2005,0,0,0,0,18
"311",91328,2005,0,0,0,0,1701
"312",91330,2005,0,0,0,0,5038
"313",91331,2005,441,29,412,3.43,12874
"314",91333,2005,0,0,0,0,24
"315",91334,2005,0,0,0,0,18
"316",91335,2005,273,0,273,3.12,8736
"317",91337,2005,0,0,0,0,45
"318",91340,2005,401,172,229,3.26,12313
"319",91341,2005,0,0,0,0,285
"320",91342,2005,420,47,373,2.29,18343
"321",91343,2005,367,144,223,4.14,8874
"322",91344,2005,431,72,359,5.4,7981
"323",91345,2005,249,0,249,4.15,6000
"324",91346,2005,0,0,0,0,123
"325",91350,2005,419,45,374,5.11,8199
"326",91351,2005,257,0,257,3.06,8393
"327",91352,2005,677,71,606,3.49,19396
"328",91353,2005,0,0,0,0,548
"329",91354,2005,18,0,18,1.9,947
"330",91355,2005,3959,762,3197,8.83,44842
"331",91356,2005,1395,173,1222,9.58,14567
"332",91357,2005,17,0,17,7.56,225
"333",91361,2005,2734,675,2059,18.1,15106
"334",91362,2005,3234,1153,2081,16.71,19350
"335",91364,2005,1826,402,1424,9.55,19121
"336",91365,2005,0,0,0,0,161
"337",91367,2005,4957,2247,2710,14.7,33727
"338",91372,2005,0,0,0,0,3
"339",91376,2005,0,0,0,0,5
"340",91380,2005,0,0,0,0,1120
"341",91381,2005,104,12,92,2.52,4119
"342",91384,2005,0,0,0,0,2097
"343",91385,2005,0,0,0,0,110
"344",91386,2005,0,0,0,0,90
"345",91387,2005,91,28,63,5.87,1550
"346",91390,2005,46,0,46,7.15,643
"347",91392,2005,0,0,0,0,2074
"348",91393,2005,0,0,0,0,57
"349",91394,2005,0,0,0,0,3
"350",91401,2005,335,42,293,4.03,8309
"351",91402,2005,328,152,176,2.93,11181
"352",91403,2005,3028,1328,1700,22.03,13744
"353",91404,2005,26,0,26,44.07,59
"354",91405,2005,1188,0,1188,8.4,14141
"355",91406,2005,2468,662,1806,9.71,25422
"356",91407,2005,0,0,0,0,4
"357",91408,2005,0,0,0,0,135
"358",91409,2005,0,0,0,0,754
"359",91410,2005,0,0,0,0,19
"360",91411,2005,1043,373,670,11.07,9420
"361",91412,2005,0,0,0,0,110
"362",91413,2005,0,0,0,0,162
"363",91416,2005,0,0,0,0,133
"364",91423,2005,2036,315,1721,18.56,10969
"365",91426,2005,0,0,0,0,33
"366",91436,2005,6347,457,5890,32.74,19388
"367",91501,2005,35,0,35,2.33,1505
"368",91502,2005,19833,18540,1293,59.13,33539
"369",91503,2005,0,0,0,0,427
"370",91504,2005,1214,0,1214,2.6,46756
"371",91505,2005,8762,7116,1646,31.65,27687
"372",91506,2005,856,266,590,10.81,7917
"373",91507,2005,0,0,0,0,47
"374",91508,2005,0,0,0,0,2
"375",91510,2005,248,248,0,21.6,1148
"376",91521,2005,5972,5900,72,72.41,8247
"377",91522,2005,6094,6094,0,95.4,6388
"378",91523,2005,1186,1186,0,93.17,1273
"379",91601,2005,1526,1090,436,20.29,7521
"380",91602,2005,677,232,445,16.53,4095
"381",91603,2005,0,0,0,0,348
"382",91604,2005,1441,688,753,14.3,10080
"383",91605,2005,679,304,375,3.92,17330
"384",91606,2005,560,196,364,6.16,9085
"385",91607,2005,717,334,383,14.12,5077
"386",91608,2005,10086,9930,156,76.39,13203
"387",91609,2005,0,0,0,0,69
"388",91610,2005,0,0,0,0,10
"389",91614,2005,0,0,0,0,68
"390",91615,2005,0,0,0,0,2
"391",91616,2005,0,0,0,0,40
"392",91618,2005,0,0,0,0,2
"393",91702,2005,242,54,188,1.42,17098
"394",91706,2005,2016,1445,571,5.89,34212
"395",91709,2005,335,43,292,4.22,7942
"396",91710,2005,828,297,531,2.08,39764
"397",91711,2005,1009,51,958,7.48,13495
"398",91714,2005,0,0,0,0,362
"399",91715,2005,0,0,0,0,1155
"400",91716,2005,0,0,0,0,236
"401",91722,2005,202,0,202,2.9,6971
"402",91723,2005,383,161,222,3.73,10268
"403",91724,2005,223,9,214,4.33,5150
"404",91731,2005,1062,188,874,5.65,18791
"405",91732,2005,102,0,102,1.7,6015
"406",91733,2005,484,57,427,2.34,20643
"407",91734,2005,0,0,0,0,1235
"408",91740,2005,328,92,236,2.91,11277
"409",91741,2005,270,14,256,6.25,4318
"410",91744,2005,265,0,265,1.99,13319
"411",91745,2005,1699,303,1396,9.01,18864
"412",91746,2005,520,71,449,3.21,16214
"413",91747,2005,0,0,0,0,1175
"414",91748,2005,1316,372,944,4.98,26449
"415",91749,2005,0,0,0,0,1376
"416",91750,2005,443,92,351,3.81,11632
"417",91754,2005,1788,720,1068,8.71,20529
"418",91755,2005,53,7,46,2.29,2314
"419",91759,2005,0,0,0,0,53
"420",91765,2005,1485,585,900,11.49,12925
"421",91766,2005,311,0,311,1.84,16876
"422",91767,2005,111,0,111,0.91,12217
"423",91768,2005,411,67,344,2.63,15653
"424",91769,2005,9,0,9,0.21,4213
"425",91770,2005,490,134,356,3.04,16133
"426",91773,2005,1322,0,1322,6.05,21869
"427",91775,2005,128,0,128,5.46,2345
"428",91776,2005,446,25,421,4.08,10939
"429",91778,2005,0,0,0,0,103
"430",91780,2005,247,61,186,4.92,5020
"431",91788,2005,0,0,0,0,427
"432",91789,2005,1394,427,967,6.05,23040
"433",91790,2005,1265,145,1120,8.68,14579
"434",91791,2005,366,28,338,4.13,8856
"435",91792,2005,28,0,28,0.58,4801
"436",91793,2005,0,0,0,0,149
"437",91801,2005,1756,874,882,11.62,15113
"438",91802,2005,0,0,0,0,282
"439",91803,2005,465,65,400,5.54,8396
"440",92397,2005,8,0,8,1.84,435
"441",92821,2005,1722,344,1378,6.09,28271
"442",92823,2005,65,0,65,2.5,2603
"443",93243,2005,0,0,0,0,1156
"444",93510,2005,35,3,32,2.45,1431
"445",93523,2005,216,0,216,29.31,737
"446",93532,2005,0,0,0,0,277
"447",93534,2005,830,153,677,3.83,21663
"448",93535,2005,373,107,266,4.08,9138
"449",93536,2005,46,0,46,0.5,9230
"450",93539,2005,0,0,0,0,1254
"451",93543,2005,0,0,0,0,1043
"452",93544,2005,0,0,0,0,201
"453",93550,2005,733,367,366,5.43,13488
"454",93551,2005,395,217,178,4.06,9737
"455",93552,2005,16,0,16,1.38,1158
"456",93553,2005,0,0,0,0,263
"457",93560,2005,37,0,37,3.05,1214
"458",93563,2005,0,0,0,0,26
"459",93584,2005,0,0,0,0,18
"460",93586,2005,0,0,0,0,2
"461",93590,2005,0,0,0,0,304
"462",93591,2005,0,0,0,0,294
"463",90001,2006,95,0,95,1.18,8078
"464",90002,2006,0,0,0,0,1306
"465",90003,2006,95,0,95,2.14,4449
"466",90004,2006,866,367,499,12.57,6890
"467",90005,2006,600,388,212,15.08,3978
"468",90006,2006,441,30,411,5.27,8372
"469",90007,2006,504,76,428,3.74,13492
"470",90008,2006,167,113,54,5.93,2815
"471",90009,2006,0,0,0,0,4289
"472",90010,2006,5601,1223,4378,17.47,32063
"473",90011,2006,93,0,93,0.95,9812
"474",90012,2006,5697,4603,1094,3.77,151208
"475",90013,2006,1016,107,909,6.9,14724
"476",90014,2006,880,45,835,6.38,13799
"477",90015,2006,1386,768,618,4.18,33154
"478",90016,2006,1417,271,1146,14.92,9497
"479",90017,2006,13684,1975,11709,34.74,39393
"480",90018,2006,178,0,178,4.44,4010
"481",90019,2006,494,77,417,8.93,5535
"482",90020,2006,163,68,95,1.42,11500
"483",90021,2006,905,0,905,3.36,26908
"484",90022,2006,475,173,302,2.76,17207
"485",90023,2006,343,16,327,1.4,24446
"486",90024,2006,3716,1424,2292,8.12,45764
"487",90025,2006,8508,2640,5868,28.54,29814
"488",90026,2006,462,105,357,8.29,5571
"489",90027,2006,2683,2330,353,12.08,22215
"490",90028,2006,6356,4137,2219,28.27,22487
"491",90029,2006,85,0,85,1.65,5140
"492",90030,2006,0,0,0,0,303
"493",90031,2006,360,50,310,3.99,9024
"494",90032,2006,134,0,134,2.27,5894
"495",90033,2006,408,0,408,2.25,18172
"496",90034,2006,1397,458,939,15.52,9004
"497",90035,2006,3067,2630,437,27.23,11264
"498",90036,2006,13954,7338,6616,46.14,30241
"499",90037,2006,218,0,218,3.56,6129
"500",90038,2006,6139,5231,908,45.94,13364
"501",90039,2006,603,66,537,6.23,9677
"502",90040,2006,2393,425,1968,5.45,43941
"503",90041,2006,469,130,339,8.1,5792
"504",90042,2006,114,15,99,3.92,2905
"505",90043,2006,61,42,19,2.22,2749
"506",90044,2006,100,53,47,3.63,2753
"507",90045,2006,5540,3143,2397,8.19,67617
"508",90046,2006,1319,528,791,10.9,12105
"509",90047,2006,80,35,45,1.95,4112
"510",90048,2006,4229,1836,2393,12.43,34023
"511",90049,2006,5466,0,5466,25,21864
"512",90050,2006,0,0,0,0,14
"513",90051,2006,0,0,0,0,343
"514",90052,2006,0,0,0,0,126
"515",90053,2006,0,0,0,0,28
"516",90054,2006,0,0,0,0,518
"517",90055,2006,0,0,0,0,47
"518",90056,2006,483,107,376,16.21,2980
"519",90057,2006,722,64,658,8,9022
"520",90058,2006,660,53,607,1.44,45904
"521",90059,2006,13,0,13,0.34,3849
"522",90060,2006,0,0,0,0,67
"523",90061,2006,176,81,95,2.65,6633
"524",90062,2006,23,0,23,1.36,1694
"525",90063,2006,122,49,73,3.13,3897
"526",90064,2006,10001,1942,8059,41.29,24220
"527",90065,2006,707,437,270,7.94,8901
"528",90066,2006,4013,796,3217,30.57,13129
"529",90067,2006,10813,3072,7741,42.96,25167
"530",90068,2006,977,499,478,26.61,3672
"531",90069,2006,2331,573,1758,15.17,15369
"532",90070,2006,0,0,0,0,144
"533",90071,2006,12383,298,12085,37.47,33046
"534",90072,2006,0,0,0,0,15
"535",90073,2006,0,0,0,0,4303
"536",90075,2006,0,0,0,0,2
"537",90076,2006,0,0,0,0,11
"538",90077,2006,100,34,66,4.61,2170
"539",90078,2006,0,0,0,0,32
"540",90079,2006,81,0,81,7.14,1135
"541",90080,2006,0,0,0,0,381
"542",90082,2006,0,0,0,0,6
"543",90083,2006,0,0,0,0,2
"544",90086,2006,116,0,116,7.68,1511
"545",90087,2006,0,0,0,0,2
"546",90089,2006,0,0,0,0,20608
"547",90091,2006,0,0,0,0,9
"548",90093,2006,0,0,0,0,3
"549",90094,2006,6,0,6,2.26,265
"550",90095,2006,176,0,176,2.18,8068
"551",90201,2006,251,86,165,1.46,17241
"552",90202,2006,0,0,0,0,69
"553",90209,2006,12,12,0,1.85,648
"554",90210,2006,2513,1175,1338,13.02,19296
"555",90211,2006,1855,1056,799,18.13,10231
"556",90212,2006,2964,515,2449,19.46,15232
"557",90213,2006,0,0,0,0,146
"558",90220,2006,1114,135,979,4.49,24787
"559",90221,2006,272,61,211,2,13632
"560",90222,2006,0,0,0,0,2612
"561",90224,2006,0,0,0,0,331
"562",90230,2006,2161,548,1613,10.36,20851
"563",90231,2006,0,0,0,0,7958
"564",90232,2006,2664,935,1729,17.16,15520
"565",90233,2006,0,0,0,0,20
"566",90240,2006,223,0,223,4.6,4845
"567",90241,2006,875,305,570,4.42,19813
"568",90242,2006,640,41,599,6.6,9699
"569",90245,2006,13926,2429,11497,24.74,56290
"570",90247,2006,134,0,134,1.05,12719
"571",90248,2006,1455,603,852,4.44,32742
"572",90249,2006,152,3,149,1.52,10033
"573",90250,2006,737,119,618,3.84,19170
"574",90251,2006,0,0,0,0,199
"575",90254,2006,506,155,351,8.99,5630
"576",90255,2006,122,122,0,1.05,11640
"577",90260,2006,227,0,227,4.01,5654
"578",90261,2006,0,0,0,0,82
"579",90262,2006,34,0,34,0.34,9951
"580",90263,2006,0,0,0,0,2722
"581",90264,2006,0,0,0,0,9
"582",90265,2006,1328,349,979,18.22,7290
"583",90266,2006,1860,411,1449,12.1,15369
"584",90267,2006,0,0,0,0,12
"585",90270,2006,41,0,41,1.42,2879
"586",90272,2006,708,132,576,16.52,4286
"587",90274,2006,643,248,395,8.58,7492
"588",90275,2006,385,19,366,12.12,3176
"589",90277,2006,681,97,584,6.74,10107
"590",90278,2006,1051,222,829,6.37,16496
"591",90280,2006,324,0,324,1.8,17984
"592",90290,2006,152,53,99,14.99,1014
"593",90291,2006,1677,517,1160,24.94,6724
"594",90292,2006,2012,302,1710,15.65,12860
"595",90293,2006,264,15,249,27.05,976
"596",90294,2006,0,0,0,0,69
"597",90295,2006,0,0,0,0,3
"598",90301,2006,437,198,239,2.77,15795
"599",90302,2006,83,0,83,2.18,3805
"600",90303,2006,94,94,0,1.85,5082
"601",90304,2006,47,0,47,1.49,3155
"602",90305,2006,25,0,25,3.47,720
"603",90306,2006,0,0,0,0,380
"604",90307,2006,0,0,0,0,4
"605",90308,2006,0,0,0,0,14
"606",90309,2006,0,0,0,0,8
"607",90310,2006,0,0,0,0,23
"608",90311,2006,0,0,0,0,7
"609",90312,2006,0,0,0,0,13
"610",90401,2006,3794,1683,2111,16.93,22405
"611",90402,2006,147,41,106,10.01,1468
"612",90403,2006,916,175,741,11.07,8274
"613",90404,2006,8145,4072,4073,32.24,25267
"614",90405,2006,3678,941,2737,22.26,16526
"615",90406,2006,0,0,0,0,86
"616",90407,2006,0,0,0,0,987
"617",90408,2006,0,0,0,0,204
"618",90409,2006,0,0,0,0,11
"619",90410,2006,0,0,0,0,127
"620",90501,2006,2972,386,2586,11.74,25312
"621",90502,2006,1267,0,1267,9.11,13913
"622",90503,2006,2558,467,2091,9.04,28284
"623",90504,2006,521,65,456,6.25,8332
"624",90505,2006,2866,327,2539,9.07,31604
"625",90506,2006,0,0,0,0,1151
"626",90507,2006,0,0,0,0,74
"627",90508,2006,0,0,0,0,12
"628",90509,2006,51,0,51,0.89,5752
"629",90510,2006,0,0,0,0,61
"630",90601,2006,300,14,286,3.07,9778
"631",90602,2006,311,10,301,4.34,7161
"632",90603,2006,194,17,177,1.23,15771
"633",90604,2006,26,0,26,1.22,2125
"634",90605,2006,211,0,211,2.8,7531
"635",90606,2006,173,33,140,3.04,5697
"636",90607,2006,0,0,0,0,258
"637",90608,2006,0,0,0,0,1922
"638",90609,2006,0,0,0,0,10
"639",90610,2006,0,0,0,0,30
"640",90623,2006,89,0,89,1.63,5459
"641",90630,2006,2837,432,2405,12.14,23372
"642",90631,2006,421,113,308,2.66,15845
"643",90637,2006,0,0,0,0,290
"644",90638,2006,624,0,624,3.44,18156
"645",90639,2006,0,0,0,0,89
"646",90640,2006,565,180,385,2.46,22949
"647",90650,2006,600,188,412,2.7,22203
"648",90651,2006,0,0,0,0,110
"649",90652,2006,0,0,0,0,3
"650",90660,2006,284,61,223,2.04,13953
"651",90661,2006,0,0,0,NA,0
"652",90662,2006,0,0,0,0,9
"653",90670,2006,1785,412,1373,3.13,57058
"654",90671,2006,0,0,0,0,5
"655",90701,2006,1464,71,1393,10.88,13457
"656",90702,2006,5,0,5,0.91,551
"657",90703,2006,3632,1360,2272,11.99,30285
"658",90704,2006,5,0,5,0.21,2424
"659",90706,2006,621,339,282,4.11,15092
"660",90707,2006,0,0,0,0,133
"661",90710,2006,161,0,161,2.18,7398
"662",90711,2006,0,0,0,0,34
"663",90712,2006,431,220,211,3.62,11895
"664",90713,2006,44,0,44,1.29,3416
"665",90714,2006,0,0,0,0,1125
"666",90715,2006,7,0,7,0.9,776
"667",90716,2006,14,0,14,0.4,3496
"668",90717,2006,207,34,173,6.62,3126
"669",90723,2006,640,37,603,3.98,16095
"670",90731,2006,744,80,664,7.01,10613
"671",90732,2006,141,21,120,4.76,2963
"672",90733,2006,0,0,0,0,285
"673",90734,2006,0,0,0,0,17
"674",90744,2006,113,27,86,1.19,9512
"675",90745,2006,498,58,440,3.14,15861
"676",90746,2006,809,389,420,6.08,13301
"677",90747,2006,0,0,0,0,1840
"678",90748,2006,0,0,0,0,821
"679",90749,2006,0,0,0,0,1256
"680",90755,2006,644,51,593,8.77,7345
"681",90801,2006,63,0,63,0.63,9978
"682",90802,2006,3390,820,2570,12.67,26747
"683",90803,2006,543,125,418,6.68,8131
"684",90804,2006,602,26,576,7.56,7967
"685",90805,2006,173,0,173,1.53,11290
"686",90806,2006,987,131,856,6.03,16373
"687",90807,2006,1192,187,1005,8.2,14535
"688",90808,2006,585,397,188,7.47,7831
"689",90809,2006,0,0,0,0,71
"690",90810,2006,1605,0,1605,14.03,11441
"691",90813,2006,234,0,234,2.24,10431
"692",90814,2006,56,14,42,4.69,1194
"693",90815,2006,305,0,305,2.97,10254
"694",90822,2006,0,0,0,0,523
"695",90831,2006,277,0,277,15.78,1755
"696",90832,2006,0,0,0,0,15
"697",90835,2006,0,0,0,0,88
"698",90840,2006,0,0,0,0,5301
"699",90846,2006,167,0,167,1.98,8447
"700",90853,2006,0,0,0,0,4
"701",91001,2006,406,78,328,11.8,3440
"702",91003,2006,0,0,0,0,13
"703",91006,2006,1090,98,992,8.98,12132
"704",91007,2006,384,96,288,3.42,11214
"705",91008,2006,0,0,0,0,4
"706",91009,2006,0,0,0,0,391
"707",91010,2006,0,0,0,0,10124
"708",91011,2006,335,109,226,6.2,5400
"709",91012,2006,0,0,0,0,7
"710",91016,2006,2510,606,1904,14.47,17345
"711",91017,2006,0,0,0,0,280
"712",91020,2006,215,50,165,8.69,2475
"713",91021,2006,0,0,0,0,32
"714",91024,2006,120,4,116,8.28,1449
"715",91025,2006,0,0,0,0,29
"716",91030,2006,778,41,737,11.03,7056
"717",91031,2006,0,0,0,0,20
"718",91040,2006,138,0,138,6.31,2186
"719",91041,2006,0,0,0,0,28
"720",91042,2006,131,69,62,5.96,2198
"721",91043,2006,0,0,0,0,16
"722",91046,2006,0,0,0,0,38
"723",91066,2006,0,0,0,0,202
"724",91077,2006,0,0,0,0,35
"725",91101,2006,3998,469,3529,13.62,29348
"726",91102,2006,0,0,0,0,187
"727",91103,2006,992,263,729,13.25,7486
"728",91104,2006,250,35,215,7.78,3215
"729",91105,2006,1392,0,1392,7.9,17629
"730",91106,2006,978,231,747,13.27,7371
"731",91107,2006,2204,865,1339,13.12,16803
"732",91108,2006,268,0,268,8.93,3000
"733",91109,2006,0,0,0,0,13077
"734",91114,2006,0,0,0,0,1
"735",91115,2006,0,0,0,0,19
"736",91116,2006,0,0,0,0,10
"737",91125,2006,0,0,0,0,65
"738",91201,2006,875,672,203,8.48,10316
"739",91202,2006,345,26,319,9.66,3572
"740",91203,2006,3756,849,2907,19.75,19014
"741",91204,2006,1107,503,604,7.94,13944
"742",91205,2006,1101,305,796,16.53,6659
"743",91206,2006,763,79,684,8.04,9495
"744",91207,2006,95,5,90,14.94,636
"745",91208,2006,218,22,196,5.23,4165
"746",91209,2006,0,0,0,0,502
"747",91210,2006,168,0,168,4.14,4057
"748",91214,2006,351,140,211,9.57,3669
"749",91221,2006,0,0,0,0,654
"750",91222,2006,0,0,0,0,9
"751",91224,2006,0,0,0,0,8
"752",91225,2006,0,0,0,0,199
"753",91226,2006,0,0,0,0,1
"754",91301,2006,2807,914,1893,20.68,13572
"755",91302,2006,2781,741,2040,16.92,16434
"756",91303,2006,763,177,586,6.58,11599
"757",91304,2006,788,258,530,5.14,15322
"758",91305,2006,0,0,0,0,190
"759",91306,2006,103,0,103,2.88,3581
"760",91307,2006,157,30,127,2.37,6633
"761",91308,2006,0,0,0,0,22
"762",91309,2006,0,0,0,0,97
"763",91310,2006,0,0,0,0,100
"764",91311,2006,3739,1347,2392,9.42,39692
"765",91313,2006,0,0,0,0,337
"766",91316,2006,978,376,602,12.95,7554
"767",91321,2006,305,74,231,3.45,8842
"768",91322,2006,0,0,0,0,323
"769",91324,2006,787,186,601,4.15,18952
"770",91325,2006,278,78,200,4.35,6391
"771",91326,2006,410,36,374,12.87,3186
"772",91327,2006,0,0,0,0,26
"773",91328,2006,0,0,0,0,1556
"774",91330,2006,0,0,0,0,5253
"775",91331,2006,424,57,367,3.52,12049
"776",91333,2006,0,0,0,0,27
"777",91334,2006,0,0,0,0,44
"778",91335,2006,280,0,280,3.37,8318
"779",91337,2006,0,0,0,0,16
"780",91340,2006,366,179,187,2.85,12849
"781",91341,2006,0,0,0,0,306
"782",91342,2006,438,50,388,2.18,20110
"783",91343,2006,277,112,165,3.18,8707
"784",91344,2006,512,83,429,6.51,7860
"785",91345,2006,277,0,277,5.19,5336
"786",91346,2006,0,0,0,0,1557
"787",91350,2006,483,56,427,5.46,8852
"788",91351,2006,277,0,277,3.51,7894
"789",91352,2006,696,57,639,3.63,19161
"790",91353,2006,0,0,0,0,529
"791",91354,2006,67,0,67,7,957
"792",91355,2006,4129,870,3259,8.54,48324
"793",91356,2006,1581,221,1360,11.2,14116
"794",91357,2006,0,0,0,0,393
"795",91361,2006,3039,579,2460,19.09,15920
"796",91362,2006,3207,1313,1894,16.11,19912
"797",91364,2006,1995,498,1497,10.76,18533
"798",91365,2006,0,0,0,0,157
"799",91367,2006,5171,2121,3050,14.63,35337
"800",91372,2006,0,0,0,0,2
"801",91376,2006,2,0,2,33.33,6
"802",91380,2006,0,0,0,0,1560
"803",91381,2006,197,39,158,5.3,3714
"804",91384,2006,0,0,0,0,2203
"805",91385,2006,0,0,0,0,24
"806",91386,2006,0,0,0,0,37
"807",91387,2006,97,31,66,4.52,2146
"808",91390,2006,99,9,90,9.31,1063
"809",91392,2006,0,0,0,0,2347
"810",91393,2006,0,0,0,0,59
"811",91394,2006,0,0,0,0,14
"812",91395,2006,0,0,0,0,1
"813",91396,2006,0,0,0,0,7
"814",91401,2006,323,30,293,4.07,7930
"815",91402,2006,335,113,222,3,11176
"816",91403,2006,3098,1224,1874,22.13,13996
"817",91404,2006,0,0,0,0,46
"818",91405,2006,1006,795,211,7.86,12805
"819",91406,2006,2427,693,1734,10.09,24051
"820",91407,2006,0,0,0,0,6
"821",91408,2006,0,0,0,0,102
"822",91409,2006,0,0,0,0,574
"823",91410,2006,0,0,0,0,20
"824",91411,2006,1167,192,975,12.69,9193
"825",91412,2006,0,0,0,0,133
"826",91413,2006,0,0,0,0,179
"827",91416,2006,0,0,0,0,78
"828",91423,2006,1782,272,1510,17.13,10404
"829",91426,2006,0,0,0,0,37
"830",91436,2006,6119,478,5641,33.39,18325
"831",91501,2006,51,0,51,3.06,1666
"832",91502,2006,19456,17966,1490,53.72,36216
"833",91503,2006,0,0,0,0,415
"834",91504,2006,1266,0,1266,2.78,45559
"835",91505,2006,5806,4075,1731,24.44,23759
"836",91506,2006,2132,1407,725,24.91,8560
"837",91507,2006,0,0,0,0,61
"838",91508,2006,0,0,0,0,2
"839",91510,2006,265,242,23,23.9,1109
"840",91521,2006,5951,5951,0,73.35,8113
"841",91522,2006,6740,6740,0,97.72,6897
"842",91523,2006,0,0,0,0,90
"843",91601,2006,1622,961,661,21.28,7622
"844",91602,2006,667,324,343,16.87,3954
"845",91603,2006,0,0,0,0,422
"846",91604,2006,1380,606,774,13.84,9970
"847",91605,2006,718,286,432,4.2,17115
"848",91606,2006,632,168,464,6.83,9259
"849",91607,2006,649,265,384,13.17,4928
"850",91608,2006,7881,7578,303,70,11259
"851",91609,2006,0,0,0,0,27
"852",91610,2006,0,0,0,0,13
"853",91614,2006,0,0,0,0,37
"854",91615,2006,0,0,0,NA,0
"855",91616,2006,0,0,0,0,35
"856",91618,2006,0,0,0,0,17
"857",91702,2006,304,30,274,1.71,17737
"858",91706,2006,2173,1511,662,6.57,33057
"859",91709,2006,460,38,422,5.7,8076
"860",91710,2006,1377,478,899,3.35,41045
"861",91711,2006,1129,45,1084,8.1,13930
"862",91714,2006,0,0,0,0,380
"863",91715,2006,0,0,0,0,1172
"864",91716,2006,0,0,0,0,1176
"865",91722,2006,190,6,184,1.95,9759
"866",91723,2006,600,218,382,8.89,6748
"867",91724,2006,248,15,233,4.9,5066
"868",91731,2006,804,166,638,4.49,17910
"869",91732,2006,64,0,64,1.19,5400
"870",91733,2006,453,51,402,2.24,20261
"871",91734,2006,0,0,0,0,1082
"872",91740,2006,426,61,365,3.63,11740
"873",91741,2006,206,26,180,4.72,4369
"874",91744,2006,234,0,234,1.88,12469
"875",91745,2006,1183,460,723,7.88,15016
"876",91746,2006,469,79,390,2.35,19972
"877",91747,2006,0,0,0,0,1091
"878",91748,2006,1468,261,1207,5.18,28339
"879",91749,2006,0,0,0,0,1042
"880",91750,2006,499,129,370,4.68,10673
"881",91754,2006,2670,652,2018,12.06,22133
"882",91755,2006,132,7,125,4.77,2769
"883",91759,2006,0,0,0,0,30
"884",91765,2006,1069,90,979,8.79,12158
"885",91766,2006,337,0,337,1.92,17528
"886",91767,2006,160,6,154,1.37,11637
"887",91768,2006,483,38,445,2.84,17004
"888",91769,2006,10,0,10,0.25,4021
"889",91770,2006,477,144,333,2.99,15954
"890",91773,2006,773,0,773,3.66,21098
"891",91775,2006,91,11,80,3.84,2369
"892",91776,2006,511,14,497,4.51,11325
"893",91778,2006,0,0,0,0,45
"894",91780,2006,283,60,223,5.55,5098
"895",91788,2006,11,0,11,2.01,546
"896",91789,2006,1047,95,952,4.84,21628
"897",91790,2006,1359,150,1209,9.62,14131
"898",91791,2006,277,49,228,3.07,9037
"899",91792,2006,30,0,30,0.59,5064
"900",91793,2006,0,0,0,0,115
"901",91801,2006,565,0,565,3.83,14755
"902",91802,2006,0,0,0,0,281
"903",91803,2006,309,49,260,3.82,8090
"904",91804,2006,0,0,0,0,38
"905",92397,2006,10,0,10,2.2,455
"906",92821,2006,2058,213,1845,5.28,38974
"907",92823,2006,88,0,88,2.86,3075
"908",93243,2006,0,0,0,0,1336
"909",93510,2006,28,0,28,2.14,1308
"910",93523,2006,298,0,298,36.3,821
"911",93532,2006,0,0,0,0,280
"912",93534,2006,1336,165,1171,5.83,22913
"913",93535,2006,351,122,229,3.9,9011
"914",93536,2006,71,0,71,0.75,9490
"915",93539,2006,0,0,0,0,174
"916",93543,2006,0,0,0,0,1292
"917",93544,2006,0,0,0,0,197
"918",93550,2006,682,400,282,4.08,16725
"919",93551,2006,515,221,294,4.81,10702
"920",93552,2006,32,0,32,2.64,1214
"921",93553,2006,0,0,0,0,283
"922",93560,2006,42,0,42,2.91,1444
"923",93563,2006,0,0,0,0,24
"924",93584,2006,0,0,0,0,2
"925",93586,2006,0,0,0,0,11
"926",93590,2006,0,0,0,0,205
"927",93591,2006,0,0,0,0,343
"928",90001,2007,125,0,125,1.51,8279
"929",90002,2007,24,0,24,1.73,1391
"930",90003,2007,65,0,65,1.44,4504
"931",90004,2007,1083,404,679,14.92,7259
"932",90005,2007,591,361,230,12.48,4736
"933",90006,2007,344,23,321,3.75,9168
"934",90007,2007,575,75,500,3.94,14577
"935",90008,2007,208,117,91,6.79,3063
"936",90009,2007,0,0,0,0,4654
"937",90010,2007,5281,1078,4203,16.51,31981
"938",90011,2007,142,74,68,1.57,9052
"939",90012,2007,6240,4943,1297,2.4,260514
"940",90013,2007,1020,94,926,6.72,15172
"941",90014,2007,845,55,790,6.11,13825
"942",90015,2007,1366,755,611,3.96,34537
"943",90016,2007,1126,280,846,12.48,9022
"944",90017,2007,14223,1960,12263,35.64,39912
"945",90018,2007,197,16,181,4.85,4065
"946",90019,2007,530,83,447,9.21,5752
"947",90020,2007,129,19,110,1.08,11971
"948",90021,2007,601,0,601,2.12,28324
"949",90022,2007,452,169,283,2.6,17415
"950",90023,2007,298,50,248,1.23,24167
"951",90024,2007,4059,1630,2429,7.99,50775
"952",90025,2007,8560,2819,5741,27.93,30649
"953",90026,2007,475,99,376,7.5,6337
"954",90027,2007,2894,2585,309,13.32,21723
"955",90028,2007,7496,4346,3150,30.84,24309
"956",90029,2007,109,0,109,1.98,5499
"957",90030,2007,3,0,3,1,299
"958",90031,2007,356,46,310,4.17,8541
"959",90032,2007,118,0,118,2.04,5788
"960",90033,2007,432,0,432,2.28,18934
"961",90034,2007,1168,272,896,11.76,9932
"962",90035,2007,3401,2894,507,27.89,12193
"963",90036,2007,12533,6604,5929,42.03,29822
"964",90037,2007,156,0,156,2.65,5892
"965",90038,2007,6072,5153,919,46.48,13064
"966",90039,2007,506,88,418,5.54,9132
"967",90040,2007,2165,415,1750,4.89,44250
"968",90041,2007,446,118,328,7.34,6077
"969",90042,2007,98,13,85,3.37,2910
"970",90043,2007,96,42,54,3.13,3068
"971",90044,2007,18,0,18,0.67,2702
"972",90045,2007,4619,1984,2635,6.77,68241
"973",90046,2007,1372,488,884,10.71,12815
"974",90047,2007,88,36,52,2.11,4176
"975",90048,2007,6507,1839,4668,17.39,37425
"976",90049,2007,5416,0,5416,28.67,18893
"977",90050,2007,0,0,0,0,3
"978",90051,2007,11,0,11,3.18,346
"979",90052,2007,0,0,0,0,3306
"980",90053,2007,0,0,0,NA,0
"981",90054,2007,0,0,0,0,652
"982",90055,2007,0,0,0,0,49
"983",90056,2007,579,71,508,19.1,3031
"984",90057,2007,684,0,684,7.24,9444
"985",90058,2007,700,73,627,1.63,42888
"986",90059,2007,2,0,2,0.05,3857
"987",90060,2007,0,0,0,0,74
"988",90061,2007,97,0,97,1.49,6515
"989",90062,2007,22,0,22,1.4,1569
"990",90063,2007,84,35,49,2.04,4122
"991",90064,2007,12161,2202,9959,46.68,26054
"992",90065,2007,715,489,226,8.22,8695
"993",90066,2007,3664,889,2775,28.4,12901
"994",90067,2007,11185,3257,7928,41.61,26881
"995",90068,2007,1366,657,709,31.4,4350
"996",90069,2007,2333,648,1685,14.52,16062
"997",90070,2007,0,0,0,0,127
"998",90071,2007,12701,390,12311,37.31,34038
"999",90072,2007,0,0,0,0,14
"1000",90073,2007,0,0,0,0,4350
"1001",90075,2007,0,0,0,0,2
"1002",90076,2007,0,0,0,0,9
"1003",90077,2007,79,0,79,3.06,2580
"1004",90078,2007,0,0,0,0,30
"1005",90079,2007,66,0,66,5.46,1209
"1006",90080,2007,0,0,0,0,329
"1007",90082,2007,0,0,0,0,23
"1008",90083,2007,0,0,0,0,2
"1009",90086,2007,123,0,123,7.68,1601
"1010",90087,2007,0,0,0,0,11
"1011",90089,2007,0,0,0,0,20514
"1012",90091,2007,0,0,0,0,3
"1013",90093,2007,0,0,0,0,105
"1014",90094,2007,17,0,17,1.64,1035
"1015",90095,2007,186,0,186,2.21,8413
"1016",90201,2007,251,107,144,1.46,17237
"1017",90202,2007,0,0,0,0,68
"1018",90209,2007,10,10,0,1.43,697
"1019",90210,2007,3246,1713,1533,15.89,20431
"1020",90211,2007,2081,1011,1070,19.07,10914
"1021",90212,2007,3023,425,2598,19.36,15613
"1022",90213,2007,0,0,0,0,325
"1023",90220,2007,954,115,839,3.76,25367
"1024",90221,2007,271,56,215,2.09,12946
"1025",90222,2007,0,0,0,0,2402
"1026",90224,2007,0,0,0,0,300
"1027",90230,2007,2037,534,1503,9.55,21319
"1028",90231,2007,0,0,0,0,8726
"1029",90232,2007,2243,550,1693,13.04,17207
"1030",90233,2007,0,0,0,0,14
"1031",90240,2007,202,0,202,4.5,4493
"1032",90241,2007,851,343,508,4.5,18907
"1033",90242,2007,604,36,568,5.51,10957
"1034",90245,2007,16147,3548,12599,26.92,59979
"1035",90247,2007,160,0,160,1.15,13961
"1036",90248,2007,1502,515,987,4.72,31847
"1037",90249,2007,142,4,138,1.48,9624
"1038",90250,2007,531,100,431,2.7,19688
"1039",90251,2007,0,0,0,0,199
"1040",90254,2007,536,147,389,8.66,6188
"1041",90255,2007,186,186,0,1.57,11874
"1042",90260,2007,260,0,260,4.44,5853
"1043",90261,2007,0,0,0,0,45
"1044",90262,2007,32,0,32,0.32,9886
"1045",90263,2007,0,0,0,0,2555
"1046",90264,2007,0,0,0,0,11
"1047",90265,2007,1403,384,1019,19.82,7080
"1048",90266,2007,2263,431,1832,14.75,15341
"1049",90267,2007,0,0,0,0,35
"1050",90270,2007,38,0,38,1.42,2677
"1051",90272,2007,628,103,525,14.45,4347
"1052",90274,2007,641,250,391,8.34,7688
"1053",90275,2007,502,16,486,15.36,3269
"1054",90277,2007,746,190,556,7.36,10136
"1055",90278,2007,1963,249,1714,11.97,16404
"1056",90280,2007,423,0,423,2.4,17592
"1057",90290,2007,133,37,96,11.97,1111
"1058",90291,2007,1659,379,1280,24.1,6883
"1059",90292,2007,1918,293,1625,14.5,13232
"1060",90293,2007,241,21,220,25.94,929
"1061",90294,2007,0,0,0,0,41
"1062",90295,2007,0,0,0,0,2
"1063",90301,2007,292,109,183,1.94,15044
"1064",90302,2007,66,0,66,1.72,3842
"1065",90303,2007,72,38,34,1.49,4834
"1066",90304,2007,51,0,51,1.51,3381
"1067",90305,2007,11,0,11,1.54,715
"1068",90306,2007,0,0,0,0,349
"1069",90307,2007,0,0,0,0,5
"1070",90308,2007,0,0,0,0,14
"1071",90309,2007,0,0,0,0,9
"1072",90310,2007,0,0,0,0,11
"1073",90311,2007,0,0,0,0,24
"1074",90312,2007,0,0,0,0,17
"1075",90401,2007,5027,2527,2500,19.64,25591
"1076",90402,2007,191,76,115,13.57,1407
"1077",90403,2007,1123,222,901,12.91,8699
"1078",90404,2007,8901,4498,4403,34.17,26046
"1079",90405,2007,3471,850,2621,21.16,16401
"1080",90406,2007,0,0,0,0,111
"1081",90407,2007,0,0,0,0,954
"1082",90408,2007,0,0,0,0,3
"1083",90409,2007,0,0,0,0,3
"1084",90410,2007,0,0,0,0,146
"1085",90411,2007,0,0,0,0,1
"1086",90501,2007,3204,553,2651,12.4,25830
"1087",90502,2007,679,0,679,5.03,13486
"1088",90503,2007,2480,432,2048,10.08,24592
"1089",90504,2007,454,72,382,3.53,12858
"1090",90505,2007,2107,0,2107,6.7,31433
"1091",90506,2007,0,0,0,0,1140
"1092",90507,2007,0,0,0,0,56
"1093",90508,2007,0,0,0,0,13
"1094",90509,2007,39,0,39,0.65,6003
"1095",90510,2007,0,0,0,0,348
"1096",90601,2007,250,5,245,2.11,11872
"1097",90602,2007,329,8,321,4.43,7430
"1098",90603,2007,180,9,171,1.23,14664
"1099",90604,2007,22,0,22,0.89,2469
"1100",90605,2007,256,0,256,3.07,8339
"1101",90606,2007,150,22,128,2.88,5208
"1102",90607,2007,0,0,0,0,126
"1103",90608,2007,0,0,0,0,1956
"1104",90609,2007,0,0,0,0,6
"1105",90610,2007,0,0,0,0,39
"1106",90623,2007,142,0,142,2.28,6219
"1107",90630,2007,2569,940,1629,11.41,22517
"1108",90631,2007,482,164,318,3.18,15175
"1109",90637,2007,0,0,0,0,338
"1110",90638,2007,789,59,730,4.17,18915
"1111",90639,2007,0,0,0,0,137
"1112",90640,2007,461,133,328,2.07,22284
"1113",90650,2007,607,200,407,2.74,22142
"1114",90651,2007,0,0,0,0,136
"1115",90652,2007,0,0,0,0,1
"1116",90660,2007,399,31,368,2.79,14279
"1117",90662,2007,0,0,0,0,8
"1118",90670,2007,1966,473,1493,3.48,56531
"1119",90671,2007,0,0,0,0,3
"1120",90701,2007,1344,68,1276,10.21,13167
"1121",90702,2007,3,0,3,0.5,603
"1122",90703,2007,3485,1411,2074,11.21,31075
"1123",90704,2007,0,0,0,0,2535
"1124",90706,2007,614,326,288,4.42,13887
"1125",90707,2007,0,0,0,0,129
"1126",90710,2007,160,0,160,2.26,7070
"1127",90711,2007,0,0,0,0,27
"1128",90712,2007,452,268,184,3.82,11817
"1129",90713,2007,53,0,53,1.33,3980
"1130",90714,2007,0,0,0,0,1116
"1131",90715,2007,6,0,6,0.75,798
"1132",90716,2007,23,0,23,0.63,3674
"1133",90717,2007,151,26,125,4.68,3225
"1134",90723,2007,516,33,483,3.19,16176
"1135",90731,2007,618,79,539,5.84,10584
"1136",90732,2007,197,34,163,6.5,3031
"1137",90733,2007,0,0,0,0,143
"1138",90734,2007,0,0,0,0,17
"1139",90744,2007,126,47,79,1.2,10504
"1140",90745,2007,552,102,450,3.62,15261
"1141",90746,2007,1284,359,925,9.17,14007
"1142",90747,2007,0,0,0,0,1310
"1143",90748,2007,0,0,0,0,448
"1144",90749,2007,0,0,0,0,1396
"1145",90755,2007,609,42,567,7.71,7897
"1146",90801,2007,117,0,117,1.06,11059
"1147",90802,2007,3557,759,2798,15.89,22381
"1148",90803,2007,554,138,416,6.51,8506
"1149",90804,2007,545,34,511,6.38,8544
"1150",90805,2007,184,6,178,1.43,12860
"1151",90806,2007,1098,81,1017,6.35,17285
"1152",90807,2007,1082,0,1082,7.23,14956
"1153",90808,2007,582,408,174,6.45,9026
"1154",90809,2007,0,0,0,0,1213
"1155",90810,2007,1567,0,1567,10.78,14531
"1156",90813,2007,171,0,171,1.47,11615
"1157",90814,2007,62,17,45,5.19,1195
"1158",90815,2007,710,271,439,6.08,11685
"1159",90822,2007,0,0,0,0,551
"1160",90831,2007,516,221,295,26.71,1932
"1161",90832,2007,0,0,0,0,16
"1162",90835,2007,0,0,0,0,95
"1163",90840,2007,0,0,0,0,6019
"1164",90846,2007,193,0,193,2.3,8380
"1165",91001,2007,381,116,265,12.21,3120
"1166",91003,2007,0,0,0,0,7
"1167",91006,2007,962,64,898,7.68,12531
"1168",91007,2007,448,140,308,3.97,11276
"1169",91008,2007,0,0,0,0,4
"1170",91009,2007,0,0,0,0,386
"1171",91010,2007,130,0,130,1.39,9368
"1172",91011,2007,387,107,280,6.9,5612
"1173",91012,2007,0,0,0,0,4
"1174",91016,2007,2498,672,1826,14.26,17519
"1175",91017,2007,0,0,0,0,256
"1176",91020,2007,268,86,182,11.09,2417
"1177",91021,2007,0,0,0,0,40
"1178",91024,2007,98,0,98,6.3,1556
"1179",91025,2007,0,0,0,0,34
"1180",91030,2007,800,34,766,10.64,7522
"1181",91031,2007,0,0,0,0,15
"1182",91040,2007,222,102,120,10.22,2172
"1183",91041,2007,0,0,0,0,56
"1184",91042,2007,148,81,67,7.48,1979
"1185",91043,2007,0,0,0,0,33
"1186",91046,2007,0,0,0,0,15
"1187",91066,2007,0,0,0,0,158
"1188",91077,2007,0,0,0,0,14
"1189",91101,2007,4094,461,3633,14.05,29130
"1190",91102,2007,0,0,0,0,194
"1191",91103,2007,1160,352,808,14.66,7913
"1192",91104,2007,206,43,163,6.62,3112
"1193",91105,2007,1667,0,1667,9.67,17242
"1194",91106,2007,1088,228,860,13.17,8263
"1195",91107,2007,1929,743,1186,10.53,18325
"1196",91108,2007,167,0,167,5.16,3236
"1197",91109,2007,0,0,0,0,14701
"1198",91114,2007,0,0,0,0,3
"1199",91115,2007,0,0,0,0,14
"1200",91116,2007,0,0,0,0,11
"1201",91117,2007,0,0,0,0,17
"1202",91125,2007,0,0,0,0,57
"1203",91201,2007,787,584,203,6.7,11749
"1204",91202,2007,303,27,276,8.52,3557
"1205",91203,2007,3585,720,2865,17.49,20495
"1206",91204,2007,800,473,327,5.36,14915
"1207",91205,2007,714,306,408,9.52,7497
"1208",91206,2007,916,160,756,9.68,9463
"1209",91207,2007,102,4,98,14.74,692
"1210",91208,2007,224,23,201,4.9,4572
"1211",91209,2007,0,0,0,0,598
"1212",91210,2007,225,0,225,4.75,4741
"1213",91214,2007,330,135,195,7.88,4187
"1214",91221,2007,0,0,0,0,557
"1215",91222,2007,0,0,0,0,13
"1216",91224,2007,0,0,0,0,9
"1217",91225,2007,0,0,0,0,2
"1218",91226,2007,0,0,0,0,1
"1219",91301,2007,2534,1077,1457,17.79,14243
"1220",91302,2007,2776,786,1990,15.92,17433
"1221",91303,2007,860,208,652,6.51,13209
"1222",91304,2007,560,108,452,3.86,14494
"1223",91305,2007,0,0,0,0,200
"1224",91306,2007,126,28,98,3.46,3639
"1225",91307,2007,171,32,139,2.51,6803
"1226",91308,2007,0,0,0,0,43
"1227",91309,2007,0,0,0,0,118
"1228",91310,2007,0,0,0,0,93
"1229",91311,2007,3909,1637,2272,10.28,38039
"1230",91313,2007,0,0,0,0,351
"1231",91316,2007,1094,177,917,13.93,7851
"1232",91321,2007,386,145,241,4.27,9039
"1233",91322,2007,0,0,0,0,331
"1234",91324,2007,879,190,689,4.74,18551
"1235",91325,2007,355,38,317,4.62,7690
"1236",91326,2007,391,39,352,11.63,3363
"1237",91327,2007,0,0,0,0,22
"1238",91328,2007,0,0,0,0,1646
"1239",91330,2007,0,0,0,0,5932
"1240",91331,2007,519,46,473,4,12970
"1241",91333,2007,0,0,0,0,25
"1242",91334,2007,0,0,0,0,31
"1243",91335,2007,252,62,190,3.05,8269
"1244",91337,2007,0,0,0,0,17
"1245",91340,2007,410,157,253,3.58,11461
"1246",91341,2007,0,0,0,0,294
"1247",91342,2007,517,30,487,2.54,20325
"1248",91343,2007,282,126,156,3.08,9161
"1249",91344,2007,551,89,462,7.08,7787
"1250",91345,2007,325,0,325,5.71,5688
"1251",91346,2007,0,0,0,0,98
"1252",91350,2007,501,57,444,5.54,9039
"1253",91351,2007,274,0,274,3.19,8578
"1254",91352,2007,604,74,530,3.09,19522
"1255",91353,2007,0,0,0,0,527
"1256",91354,2007,86,16,70,7.5,1146
"1257",91355,2007,3769,721,3048,7.96,47362
"1258",91356,2007,1179,240,939,8.42,14002
"1259",91357,2007,28,0,28,11.62,241
"1260",91361,2007,2810,490,2320,17.65,15924
"1261",91362,2007,3083,686,2397,15.48,19917
"1262",91364,2007,2033,437,1596,11.16,18222
"1263",91365,2007,0,0,0,0,187
"1264",91367,2007,4976,2192,2784,14.67,33924
"1265",91372,2007,0,0,0,0,3
"1266",91376,2007,0,0,0,0,29
"1267",91380,2007,0,0,0,0,1744
"1268",91381,2007,153,39,114,3.5,4373
"1269",91383,2007,0,0,0,0,1486
"1270",91384,2007,188,0,188,8.91,2111
"1271",91385,2007,0,0,0,0,158
"1272",91386,2007,0,0,0,0,50
"1273",91387,2007,121,35,86,5.02,2411
"1274",91390,2007,88,4,84,9.13,964
"1275",91392,2007,0,0,0,0,2304
"1276",91393,2007,0,0,0,0,77
"1277",91394,2007,0,0,0,0,19
"1278",91396,2007,0,0,0,0,7
"1279",91401,2007,343,64,279,3.86,8887
"1280",91402,2007,335,115,220,3.04,11013
"1281",91403,2007,3080,1124,1956,22.28,13824
"1282",91404,2007,0,0,0,0,51
"1283",91405,2007,886,0,886,6.79,13047
"1284",91406,2007,2524,800,1724,11.01,22921
"1285",91407,2007,0,0,0,0,11
"1286",91408,2007,0,0,0,0,112
"1287",91409,2007,0,0,0,0,992
"1288",91410,2007,0,0,0,0,18
"1289",91411,2007,1100,443,657,11.99,9177
"1290",91412,2007,0,0,0,0,98
"1291",91413,2007,0,0,0,0,219
"1292",91416,2007,0,0,0,0,56
"1293",91423,2007,2347,393,1954,21.67,10829
"1294",91426,2007,0,0,0,0,39
"1295",91436,2007,6621,631,5990,36.61,18083
"1296",91501,2007,125,51,74,8.73,1432
"1297",91502,2007,23877,22671,1206,59.32,40249
"1298",91503,2007,0,0,0,0,423
"1299",91504,2007,40153,39147,1006,79.64,50417
"1300",91505,2007,7165,5223,1942,22.95,31215
"1301",91506,2007,813,303,510,10.57,7689
"1302",91507,2007,0,0,0,0,65
"1303",91508,2007,0,0,0,0,1
"1304",91510,2007,263,263,0,22.56,1166
"1305",91521,2007,5880,5809,71,75.73,7764
"1306",91522,2007,6039,6039,0,97.51,6193
"1307",91523,2007,1354,1354,0,93.7,1445
"1308",91601,2007,1608,1091,517,19.49,8252
"1309",91602,2007,636,193,443,14.16,4492
"1310",91603,2007,0,0,0,0,217
"1311",91604,2007,1381,611,770,13.7,10082
"1312",91605,2007,609,241,368,3.63,16786
"1313",91606,2007,588,175,413,7.85,7488
"1314",91607,2007,750,371,379,13.01,5763
"1315",91608,2007,9520,9303,217,75.23,12654
"1316",91609,2007,0,0,0,0,30
"1317",91610,2007,0,0,0,0,13
"1318",91614,2007,0,0,0,0,22
"1319",91615,2007,0,0,0,0,170
"1320",91616,2007,0,0,0,0,52
"1321",91618,2007,0,0,0,0,8
"1322",91702,2007,202,45,157,1.24,16299
"1323",91706,2007,1718,1134,584,4.99,34454
"1324",91709,2007,410,46,364,4.53,9043
"1325",91710,2007,1141,299,842,2.84,40145
"1326",91711,2007,1164,56,1108,8.51,13679
"1327",91714,2007,0,0,0,0,353
"1328",91715,2007,0,0,0,0,1775
"1329",91716,2007,0,0,0,0,484
"1330",91722,2007,198,7,191,3.01,6575
"1331",91723,2007,369,124,245,3.61,10220
"1332",91724,2007,246,0,246,4.61,5337
"1333",91731,2007,760,172,588,4.23,17964
"1334",91732,2007,181,0,181,2.95,6137
"1335",91733,2007,429,0,429,2.1,20398
"1336",91734,2007,0,0,0,0,1133
"1337",91740,2007,502,91,411,4.05,12407
"1338",91741,2007,202,8,194,4.48,4506
"1339",91744,2007,342,0,342,2.58,13231
"1340",91745,2007,1720,391,1329,9.09,18926
"1341",91746,2007,423,57,366,2.32,18251
"1342",91747,2007,0,0,0,0,1124
"1343",91748,2007,1141,259,882,4.08,27949
"1344",91749,2007,0,0,0,0,930
"1345",91750,2007,496,131,365,4.33,11462
"1346",91754,2007,1932,610,1322,9.11,21199
"1347",91755,2007,87,9,78,3.13,2780
"1348",91759,2007,0,0,0,0,49
"1349",91765,2007,1364,321,1043,10.66,12801
"1350",91766,2007,304,0,304,1.83,16643
"1351",91767,2007,268,0,268,2.17,12352
"1352",91768,2007,344,0,344,2.18,15776
"1353",91769,2007,0,0,0,0,3926
"1354",91770,2007,623,132,491,3.93,15842
"1355",91773,2007,955,0,955,4.66,20493
"1356",91775,2007,89,0,89,3.67,2422
"1357",91776,2007,427,12,415,4.38,9756
"1358",91778,2007,0,0,0,0,815
"1359",91780,2007,312,90,222,6.01,5190
"1360",91788,2007,0,0,0,0,493
"1361",91789,2007,1143,63,1080,5.08,22488
"1362",91790,2007,1273,156,1117,8.75,14548
"1363",91791,2007,330,75,255,3.48,9471
"1364",91792,2007,40,0,40,0.99,4026
"1365",91793,2007,0,0,0,0,109
"1366",91801,2007,523,0,523,3.5,14931
"1367",91802,2007,0,0,0,0,420
"1368",91803,2007,475,44,431,5.51,8613
"1369",91804,2007,0,0,0,0,12
"1370",92397,2007,0,0,0,0,403
"1371",92821,2007,2113,196,1917,7.05,29976
"1372",92823,2007,126,0,126,3.8,3312
"1373",93243,2007,0,0,0,0,1359
"1374",93510,2007,13,4,9,0.93,1404
"1375",93523,2007,256,0,256,29.02,882
"1376",93532,2007,0,0,0,0,231
"1377",93534,2007,1294,132,1162,5.57,23225
"1378",93535,2007,319,107,212,3.79,8408
"1379",93536,2007,69,0,69,0.69,9931
"1380",93539,2007,0,0,0,0,869
"1381",93543,2007,4,0,4,0.36,1115
"1382",93544,2007,0,0,0,0,215
"1383",93550,2007,727,400,327,4.33,16783
"1384",93551,2007,454,231,223,4.28,10619
"1385",93552,2007,14,0,14,1.23,1141
"1386",93553,2007,0,0,0,0,310
"1387",93560,2007,36,0,36,2.58,1396
"1388",93563,2007,0,0,0,0,25
"1389",93584,2007,0,0,0,0,4
"1390",93586,2007,0,0,0,0,12
"1391",93590,2007,0,0,0,0,203
"1392",93591,2007,0,0,0,0,300
"1393",90001,2008,82,0,82,1.01,8079
"1394",90002,2008,0,0,0,0,1387
"1395",90003,2008,29,0,29,0.65,4450
"1396",90004,2008,1144,366,778,15.17,7539
"1397",90005,2008,598,368,230,11.86,5043
"1398",90006,2008,359,46,313,4.52,7947
"1399",90007,2008,438,81,357,3.08,14219
"1400",90008,2008,190,117,73,6.19,3069
"1401",90009,2008,0,0,0,0,4145
"1402",90010,2008,5428,1286,4142,15.87,34205
"1403",90011,2008,71,0,71,0.78,9131
"1404",90012,2008,5544,3977,1567,2.16,256252
"1405",90013,2008,1013,118,895,6.93,14621
"1406",90014,2008,868,70,798,6.55,13257
"1407",90015,2008,613,0,613,1.73,35333
"1408",90016,2008,710,313,397,8.39,8458
"1409",90017,2008,14052,1864,12188,34.93,40226
"1410",90018,2008,217,21,196,5.25,4132
"1411",90019,2008,415,110,305,7.11,5834
"1412",90020,2008,124,16,108,1.03,12063
"1413",90021,2008,508,0,508,1.65,30718
"1414",90022,2008,503,171,332,3.06,16428
"1415",90023,2008,301,45,256,1.35,22305
"1416",90024,2008,4526,1802,2724,8.69,52089
"1417",90025,2008,8280,2851,5429,26.45,31300
"1418",90026,2008,548,115,433,8.55,6406
"1419",90027,2008,2055,1712,343,9.57,21480
"1420",90028,2008,7407,4235,3172,30.15,24571
"1421",90029,2008,72,0,72,1.33,5401
"1422",90030,2008,4,0,4,1.19,335
"1423",90031,2008,383,40,343,4.56,8397
"1424",90032,2008,111,0,111,1.82,6089
"1425",90033,2008,412,0,412,2.19,18843
"1426",90034,2008,1234,271,963,13.25,9315
"1427",90035,2008,3371,2952,419,27.1,12437
"1428",90036,2008,6591,3893,2698,26.99,24418
"1429",90037,2008,148,0,148,2.36,6264
"1430",90038,2008,6205,5325,880,47.61,13032
"1431",90039,2008,505,85,420,5.45,9260
"1432",90040,2008,2240,371,1869,5.13,43678
"1433",90041,2008,472,131,341,7.8,6054
"1434",90042,2008,144,64,80,4.69,3070
"1435",90043,2008,46,0,46,1.22,3779
"1436",90044,2008,31,22,9,1.2,2591
"1437",90045,2008,4642,2009,2633,6.81,68207
"1438",90046,2008,1252,358,894,9.64,12992
"1439",90047,2008,71,30,41,1.73,4111
"1440",90048,2008,6884,1708,5176,18.4,37416
"1441",90049,2008,6887,0,6887,33.66,20461
"1442",90051,2008,21,0,21,6.21,338
"1443",90052,2008,0,0,0,0,3223
"1444",90053,2008,0,0,0,0,14
"1445",90054,2008,0,0,0,0,637
"1446",90055,2008,0,0,0,0,44
"1447",90056,2008,478,262,216,18.56,2576
"1448",90057,2008,780,0,780,7.72,10108
"1449",90058,2008,58,58,0,0.14,42801
"1450",90059,2008,0,0,0,0,3592
"1451",90060,2008,0,0,0,0,62
"1452",90061,2008,89,0,89,1.42,6281
"1453",90062,2008,23,0,23,1.46,1580
"1454",90063,2008,100,32,68,2.56,3903
"1455",90064,2008,7206,2368,4838,33.36,21601
"1456",90065,2008,699,458,241,8.37,8352
"1457",90066,2008,3953,897,3056,29.62,13344
"1458",90067,2008,10825,2918,7907,41.76,25921
"1459",90068,2008,1538,665,873,31.78,4840
"1460",90069,2008,2372,656,1716,14.34,16538
"1461",90070,2008,0,0,0,0,124
"1462",90071,2008,13253,381,12872,40.28,32903
"1463",90072,2008,0,0,0,0,14
"1464",90073,2008,0,0,0,0,4307
"1465",90075,2008,0,0,0,0,4
"1466",90076,2008,0,0,0,0,7
"1467",90077,2008,120,28,92,4.64,2586
"1468",90078,2008,0,0,0,0,20
"1469",90079,2008,70,0,70,5.72,1223
"1470",90080,2008,0,0,0,0,249
"1471",90082,2008,0,0,0,0,2
"1472",90083,2008,0,0,0,0,2
"1473",90086,2008,163,0,163,10.52,1549
"1474",90087,2008,0,0,0,0,9
"1475",90089,2008,0,0,0,0,21043
"1476",90091,2008,0,0,0,0,11
"1477",90093,2008,0,0,0,0,110
"1478",90094,2008,30,0,30,2.82,1063
"1479",90095,2008,207,0,207,2.39,8654
"1480",90201,2008,277,124,153,1.69,16397
"1481",90202,2008,0,0,0,0,74
"1482",90209,2008,10,10,0,1.49,669
"1483",90210,2008,3459,1859,1600,16.81,20580
"1484",90211,2008,1880,822,1058,17.15,10961
"1485",90212,2008,2935,454,2481,18.42,15937
"1486",90213,2008,0,0,0,0,332
"1487",90220,2008,1034,178,856,4.19,24704
"1488",90221,2008,283,53,230,2.16,13101
"1489",90222,2008,0,0,0,0,2433
"1490",90224,2008,0,0,0,0,266
"1491",90230,2008,2142,574,1568,10.38,20633
"1492",90231,2008,0,0,0,0,8491
"1493",90232,2008,2486,594,1892,14.53,17105
"1494",90233,2008,0,0,0,0,10
"1495",90240,2008,188,0,188,4.48,4194
"1496",90241,2008,676,287,389,3.44,19668
"1497",90242,2008,581,38,543,5.28,11014
"1498",90245,2008,17300,3915,13385,28.95,59752
"1499",90247,2008,130,0,130,0.93,13954
"1500",90248,2008,1876,805,1071,6.07,30898
"1501",90249,2008,82,0,82,0.85,9614
"1502",90250,2008,792,120,672,3.91,20231
"1503",90251,2008,0,0,0,0,190
"1504",90254,2008,568,188,380,9.21,6165
"1505",90255,2008,845,198,647,6.67,12673
"1506",90260,2008,354,0,354,6.47,5470
"1507",90261,2008,28,0,28,73.68,38
"1508",90262,2008,56,0,56,0.57,9758
"1509",90263,2008,0,0,0,0,1337
"1510",90264,2008,0,0,0,0,10
"1511",90265,2008,1218,372,846,17.31,7038
"1512",90266,2008,2320,445,1875,15.27,15190
"1513",90267,2008,0,0,0,0,26
"1514",90270,2008,49,0,49,1.46,3353
"1515",90272,2008,668,115,553,14.82,4508
"1516",90274,2008,645,261,384,8.61,7495
"1517",90275,2008,523,30,493,15.34,3409
"1518",90277,2008,828,242,586,7.94,10426
"1519",90278,2008,2134,230,1904,12.66,16850
"1520",90280,2008,502,0,502,3.16,15905
"1521",90290,2008,72,28,44,7.52,957
"1522",90291,2008,2236,817,1419,28.02,7979
"1523",90292,2008,1956,316,1640,15.79,12389
"1524",90293,2008,291,22,269,30.12,966
"1525",90294,2008,0,0,0,0,86
"1526",90295,2008,0,0,0,0,3
"1527",90301,2008,352,97,255,2.41,14579
"1528",90302,2008,69,0,69,1.84,3755
"1529",90303,2008,40,40,0,0.81,4929
"1530",90304,2008,48,0,48,1.42,3382
"1531",90305,2008,9,0,9,1.36,661
"1532",90306,2008,0,0,0,0,336
"1533",90307,2008,0,0,0,0,4
"1534",90308,2008,0,0,0,0,14
"1535",90309,2008,0,0,0,NA,0
"1536",90310,2008,0,0,0,0,12
"1537",90311,2008,0,0,0,0,24
"1538",90312,2008,0,0,0,0,16
"1539",90401,2008,5653,3010,2643,21.6,26174
"1540",90402,2008,199,56,143,13.49,1475
"1541",90403,2008,1110,185,925,12.59,8817
"1542",90404,2008,8682,4091,4591,33.96,25568
"1543",90405,2008,3548,903,2645,21.34,16623
"1544",90406,2008,0,0,0,0,110
"1545",90407,2008,0,0,0,0,964
"1546",90408,2008,0,0,0,0,3
"1547",90409,2008,0,0,0,0,4
"1548",90410,2008,0,0,0,0,140
"1549",90411,2008,0,0,0,NA,0
"1550",90501,2008,3004,566,2438,11.5,26117
"1551",90502,2008,636,0,636,3.89,16330
"1552",90503,2008,2556,438,2118,8.98,28470
"1553",90504,2008,437,72,365,5.71,7658
"1554",90505,2008,2209,160,2049,7.13,30974
"1555",90506,2008,0,0,0,0,1173
"1556",90507,2008,0,0,0,0,72
"1557",90508,2008,0,0,0,0,10
"1558",90509,2008,45,0,45,0.72,6281
"1559",90510,2008,0,0,0,0,332
"1560",90601,2008,290,4,286,2.61,11113
"1561",90602,2008,415,9,406,5.45,7608
"1562",90603,2008,224,24,200,5.12,4371
"1563",90604,2008,42,5,37,1.88,2239
"1564",90605,2008,229,0,229,2.77,8281
"1565",90606,2008,140,34,106,2.86,4896
"1566",90607,2008,0,0,0,0,67
"1567",90608,2008,0,0,0,0,1865
"1568",90609,2008,0,0,0,0,11
"1569",90610,2008,0,0,0,0,31
"1570",90623,2008,0,0,0,0,6187
"1571",90630,2008,2715,1025,1690,11.52,23561
"1572",90631,2008,486,182,304,3.27,14874
"1573",90637,2008,0,0,0,0,382
"1574",90638,2008,632,59,573,3.48,18166
"1575",90639,2008,0,0,0,0,102
"1576",90640,2008,558,169,389,2.52,22105
"1577",90650,2008,671,157,514,3.11,21589
"1578",90651,2008,0,0,0,0,128
"1579",90652,2008,0,0,0,0,2
"1580",90660,2008,397,91,306,2.82,14091
"1581",90662,2008,0,0,0,0,7
"1582",90670,2008,2027,568,1459,3.65,55504
"1583",90671,2008,0,0,0,0,3
"1584",90701,2008,991,58,933,8.44,11736
"1585",90702,2008,0,0,0,0,704
"1586",90703,2008,2056,0,2056,7.04,29195
"1587",90704,2008,5,0,5,0.2,2449
"1588",90706,2008,591,343,248,4.27,13833
"1589",90707,2008,0,0,0,0,131
"1590",90710,2008,182,31,151,2.6,6995
"1591",90711,2008,0,0,0,0,39
"1592",90712,2008,419,259,160,3.83,10952
"1593",90713,2008,58,0,58,1.51,3836
"1594",90714,2008,0,0,0,0,1079
"1595",90715,2008,7,0,7,0.9,781
"1596",90716,2008,15,0,15,0.4,3710
"1597",90717,2008,133,28,105,4.24,3138
"1598",90723,2008,597,87,510,3.84,15550
"1599",90731,2008,948,99,849,8.71,10890
"1600",90732,2008,133,14,119,4.19,3175
"1601",90733,2008,0,0,0,0,185
"1602",90734,2008,0,0,0,0,5
"1603",90744,2008,107,22,85,0.97,11078
"1604",90745,2008,581,48,533,3.87,14998
"1605",90746,2008,1018,0,1018,7.17,14197
"1606",90747,2008,0,0,0,0,1994
"1607",90748,2008,0,0,0,0,445
"1608",90749,2008,0,0,0,0,1430
"1609",90755,2008,531,41,490,6.22,8531
"1610",90801,2008,137,0,137,1.2,11387
"1611",90802,2008,3484,735,2749,12.42,28057
"1612",90803,2008,582,128,454,6.75,8619
"1613",90804,2008,539,72,467,6.62,8147
"1614",90805,2008,194,6,188,1.55,12528
"1615",90806,2008,1025,43,982,6.13,16732
"1616",90807,2008,1099,0,1099,7.24,15184
"1617",90808,2008,534,381,153,5.56,9606
"1618",90809,2008,0,0,0,0,1124
"1619",90810,2008,1721,0,1721,11.85,14520
"1620",90813,2008,212,0,212,1.84,11492
"1621",90814,2008,79,20,59,6.22,1270
"1622",90815,2008,700,281,419,6.46,10835
"1623",90822,2008,0,0,0,0,470
"1624",90831,2008,324,0,324,15.62,2074
"1625",90832,2008,0,0,0,0,16
"1626",90840,2008,0,0,0,0,5424
"1627",90846,2008,169,0,169,2.04,8278
"1628",90853,2008,0,0,0,0,3
"1629",91001,2008,305,103,202,10.52,2898
"1630",91003,2008,0,0,0,0,11
"1631",91006,2008,996,42,954,7.72,12899
"1632",91007,2008,736,143,593,6.36,11581
"1633",91008,2008,0,0,0,0,3
"1634",91009,2008,0,0,0,0,369
"1635",91010,2008,143,0,143,1.26,11313
"1636",91011,2008,371,95,276,6.17,6016
"1637",91012,2008,0,0,0,0,19
"1638",91016,2008,2141,474,1667,12.43,17226
"1639",91017,2008,0,0,0,0,259
"1640",91020,2008,271,114,157,10.92,2482
"1641",91021,2008,0,0,0,0,48
"1642",91024,2008,90,6,84,5.66,1590
"1643",91025,2008,0,0,0,0,31
"1644",91030,2008,780,42,738,10.98,7104
"1645",91031,2008,0,0,0,0,20
"1646",91040,2008,233,90,143,10.7,2177
"1647",91041,2008,0,0,0,0,52
"1648",91042,2008,169,85,84,7.74,2184
"1649",91043,2008,0,0,0,0,22
"1650",91046,2008,0,0,0,0,30
"1651",91066,2008,0,0,0,0,148
"1652",91077,2008,0,0,0,0,12
"1653",91101,2008,4338,471,3867,16.08,26980
"1654",91102,2008,0,0,0,0,8
"1655",91103,2008,1416,472,944,17.66,8019
"1656",91104,2008,219,42,177,7.19,3047
"1657",91105,2008,1715,0,1715,9.23,18571
"1658",91106,2008,857,253,604,10.76,7967
"1659",91107,2008,1584,348,1236,9.33,16986
"1660",91108,2008,221,0,221,6.68,3307
"1661",91109,2008,0,0,0,0,10935
"1662",91114,2008,0,0,0,0,7
"1663",91115,2008,0,0,0,0,12
"1664",91116,2008,0,0,0,0,10
"1665",91125,2008,0,0,0,0,64
"1666",91201,2008,705,480,225,5.97,11806
"1667",91202,2008,327,22,305,9.76,3350
"1668",91203,2008,3533,637,2896,18.67,18926
"1669",91204,2008,1165,486,679,7.83,14886
"1670",91205,2008,789,304,485,11.68,6758
"1671",91206,2008,611,71,540,7.14,8557
"1672",91207,2008,108,11,97,15.93,678
"1673",91208,2008,244,16,228,5.63,4331
"1674",91209,2008,0,0,0,0,409
"1675",91210,2008,246,0,246,4.98,4937
"1676",91214,2008,367,110,257,8.36,4392
"1677",91221,2008,0,0,0,0,326
"1678",91222,2008,0,0,0,0,15
"1679",91224,2008,0,0,0,0,8
"1680",91225,2008,0,0,0,0,3
"1681",91226,2008,0,0,0,0,1
"1682",91301,2008,2755,1171,1584,19.36,14234
"1683",91302,2008,2764,694,2070,17.16,16106
"1684",91303,2008,688,215,473,5.39,12754
"1685",91304,2008,473,112,361,3.58,13216
"1686",91305,2008,0,0,0,0,224
"1687",91306,2008,149,39,110,4.29,3476
"1688",91307,2008,139,23,116,2.03,6856
"1689",91308,2008,0,0,0,0,39
"1690",91309,2008,0,0,0,0,28
"1691",91310,2008,0,0,0,0,79
"1692",91311,2008,3958,1604,2354,10.53,37588
"1693",91313,2008,0,0,0,0,329
"1694",91316,2008,1245,151,1094,16.15,7707
"1695",91321,2008,359,133,226,4.09,8773
"1696",91322,2008,0,0,0,0,292
"1697",91324,2008,853,170,683,4.99,17093
"1698",91325,2008,252,41,211,3.18,7934
"1699",91326,2008,334,34,300,9.26,3605
"1700",91327,2008,0,0,0,0,18
"1701",91328,2008,0,0,0,0,2210
"1702",91330,2008,0,0,0,0,5648
"1703",91331,2008,467,44,423,3.84,12177
"1704",91333,2008,0,0,0,0,25
"1705",91334,2008,0,0,0,0,50
"1706",91335,2008,349,84,265,4.12,8462
"1707",91337,2008,0,0,0,0,20
"1708",91340,2008,406,153,253,3.79,10714
"1709",91341,2008,0,0,0,0,277
"1710",91342,2008,657,18,639,3.2,20523
"1711",91343,2008,248,102,146,2.7,9180
"1712",91344,2008,507,87,420,6.63,7643
"1713",91345,2008,323,0,323,5.8,5569
"1714",91346,2008,0,0,0,0,1791
"1715",91350,2008,387,65,322,4.51,8574
"1716",91351,2008,457,152,305,5.16,8855
"1717",91352,2008,491,46,445,2.56,19150
"1718",91353,2008,0,0,0,0,569
"1719",91354,2008,102,18,84,8.61,1184
"1720",91355,2008,3897,679,3218,8.46,46060
"1721",91356,2008,1123,182,941,8.07,13916
"1722",91357,2008,6,0,6,2.78,216
"1723",91361,2008,2752,540,2212,18.68,14730
"1724",91362,2008,2993,505,2488,15.32,19542
"1725",91364,2008,1924,375,1549,11.04,17426
"1726",91365,2008,0,0,0,0,261
"1727",91367,2008,4604,1803,2801,13.94,33025
"1728",91372,2008,0,0,0,0,4
"1729",91376,2008,2,0,2,7.14,28
"1730",91380,2008,0,0,0,0,1683
"1731",91381,2008,165,30,135,4.13,3999
"1732",91383,2008,0,0,0,0,1508
"1733",91384,2008,150,45,105,7.65,1962
"1734",91385,2008,0,0,0,0,20
"1735",91386,2008,0,0,0,0,37
"1736",91387,2008,99,25,74,4.39,2253
"1737",91390,2008,78,10,68,8.13,959
"1738",91392,2008,0,0,0,0,2316
"1739",91393,2008,0,0,0,0,63
"1740",91394,2008,0,0,0,0,18
"1741",91395,2008,0,0,0,0,4
"1742",91396,2008,0,0,0,0,7
"1743",91401,2008,315,41,274,3.71,8491
"1744",91402,2008,368,139,229,3.43,10743
"1745",91403,2008,3320,1200,2120,23.51,14122
"1746",91404,2008,0,0,0,0,37
"1747",91405,2008,697,0,697,5.7,12227
"1748",91406,2008,2210,701,1509,10.41,21222
"1749",91407,2008,0,0,0,0,11
"1750",91408,2008,0,0,0,0,107
"1751",91409,2008,0,0,0,0,835
"1752",91410,2008,0,0,0,0,18
"1753",91411,2008,1377,520,857,15.64,8805
"1754",91412,2008,0,0,0,0,105
"1755",91413,2008,0,0,0,0,215
"1756",91416,2008,0,0,0,0,33
"1757",91423,2008,1737,419,1318,16.68,10414
"1758",91426,2008,0,0,0,0,37
"1759",91436,2008,6543,562,5981,36.98,17694
"1760",91501,2008,106,31,75,6.77,1566
"1761",91502,2008,21759,20158,1601,57.16,38066
"1762",91503,2008,0,0,0,0,412
"1763",91504,2008,49872,49048,824,83.24,59912
"1764",91505,2008,6965,4793,2172,26.07,26714
"1765",91506,2008,886,346,540,11.73,7552
"1766",91507,2008,0,0,0,0,68
"1767",91508,2008,0,0,0,0,2
"1768",91510,2008,0,0,0,0,1134
"1769",91521,2008,6333,6230,103,76.06,8326
"1770",91522,2008,6264,6264,0,97.22,6443
"1771",91523,2008,1238,1238,0,93.72,1321
"1772",91601,2008,1535,1162,373,18.72,8200
"1773",91602,2008,803,347,456,17.63,4555
"1774",91603,2008,0,0,0,0,224
"1775",91604,2008,1354,637,717,13.35,10142
"1776",91605,2008,610,263,347,3.85,15828
"1777",91606,2008,621,152,469,7.75,8011
"1778",91607,2008,629,335,294,11.47,5484
"1779",91608,2008,8756,8238,518,72.48,12081
"1780",91609,2008,0,0,0,0,24
"1781",91610,2008,0,0,0,0,10
"1782",91614,2008,0,0,0,0,24
"1783",91615,2008,0,0,0,0,164
"1784",91616,2008,0,0,0,0,52
"1785",91618,2008,0,0,0,0,12
"1786",91702,2008,278,49,229,1.7,16318
"1787",91706,2008,1636,1082,554,4.65,35205
"1788",91709,2008,393,44,349,3.84,10226
"1789",91710,2008,1158,303,855,2.94,39389
"1790",91711,2008,1094,53,1041,8.21,13323
"1791",91714,2008,0,0,0,0,334
"1792",91715,2008,0,0,0,0,1772
"1793",91716,2008,0,0,0,0,493
"1794",91722,2008,229,0,229,3.37,6787
"1795",91723,2008,442,168,274,4.6,9600
"1796",91724,2008,218,0,218,3.75,5807
"1797",91731,2008,820,172,648,4.22,19413
"1798",91732,2008,230,0,230,4.26,5405
"1799",91733,2008,457,67,390,2.28,20057
"1800",91734,2008,0,0,0,0,1023
"1801",91740,2008,1058,84,974,8.7,12167
"1802",91741,2008,215,7,208,4.82,4463
"1803",91744,2008,294,0,294,2.34,12589
"1804",91745,2008,1525,379,1146,8.4,18152
"1805",91746,2008,385,65,320,2.13,18091
"1806",91747,2008,0,0,0,0,619
"1807",91748,2008,1230,230,1000,4.44,27701
"1808",91749,2008,0,0,0,0,1100
"1809",91750,2008,514,117,397,4.78,10747
"1810",91754,2008,1742,598,1144,8.17,21333
"1811",91755,2008,115,8,107,4.91,2342
"1812",91759,2008,0,0,0,0,37
"1813",91765,2008,1112,113,999,9.04,12297
"1814",91766,2008,273,0,273,1.8,15169
"1815",91767,2008,492,243,249,3.91,12580
"1816",91768,2008,513,58,455,3.1,16531
"1817",91769,2008,8,0,8,0.21,3882
"1818",91770,2008,577,103,474,3.76,15352
"1819",91773,2008,959,0,959,4.85,19786
"1820",91775,2008,105,12,93,4.29,2448
"1821",91776,2008,422,22,400,4.3,9819
"1822",91778,2008,0,0,0,0,818
"1823",91780,2008,249,97,152,4.83,5156
"1824",91788,2008,0,0,0,0,402
"1825",91789,2008,1216,70,1146,6.02,20213
"1826",91790,2008,1067,140,927,8.14,13101
"1827",91791,2008,364,109,255,4.19,8683
"1828",91792,2008,72,0,72,1.93,3723
"1829",91793,2008,0,0,0,0,114
"1830",91801,2008,608,0,608,4.09,14849
"1831",91802,2008,0,0,0,0,416
"1832",91803,2008,320,44,276,3.81,8399
"1833",91804,2008,0,0,0,0,13
"1834",92397,2008,0,0,0,0,392
"1835",92821,2008,2062,179,1883,6.72,30698
"1836",92823,2008,136,0,136,3.8,3576
"1837",93243,2008,0,0,0,0,1323
"1838",93510,2008,21,0,21,1.52,1381
"1839",93523,2008,238,0,238,26.21,908
"1840",93532,2008,0,0,0,0,223
"1841",93534,2008,1355,130,1225,5.79,23398
"1842",93535,2008,294,96,198,3.72,7906
"1843",93536,2008,69,0,69,0.68,10140
"1844",93539,2008,0,0,0,0,100
"1845",93543,2008,0,0,0,0,1231
"1846",93544,2008,0,0,0,0,174
"1847",93550,2008,683,363,320,4.28,15976
"1848",93551,2008,556,287,269,5.22,10648
"1849",93552,2008,15,0,15,0.83,1814
"1850",93553,2008,0,0,0,0,272
"1851",93560,2008,36,0,36,2.56,1404
"1852",93563,2008,0,0,0,0,77
"1853",93584,2008,0,0,0,0,29
"1854",93586,2008,0,0,0,0,12
"1855",93590,2008,0,0,0,0,183
"1856",93591,2008,0,0,0,0,470
"1857",90001,2009,32,0,32,0.45,7138
"1858",90002,2009,0,0,0,0,1297
"1859",90003,2009,45,0,45,1.07,4206
"1860",90004,2009,940,268,672,12.86,7312
"1861",90005,2009,581,322,259,12.37,4698
"1862",90006,2009,325,35,290,4.35,7469
"1863",90007,2009,325,79,246,2.61,12470
"1864",90008,2009,116,78,38,4.14,2799
"1865",90009,2009,0,0,0,0,4085
"1866",90010,2009,4789,805,3984,15.59,30714
"1867",90011,2009,70,0,70,0.84,8323
"1868",90012,2009,5389,3818,1571,3.45,156065
"1869",90013,2009,1157,228,929,8.05,14368
"1870",90014,2009,737,35,702,6.13,12022
"1871",90015,2009,578,0,578,1.72,33612
"1872",90016,2009,891,316,575,11.03,8079
"1873",90017,2009,12865,1595,11270,34.87,36896
"1874",90018,2009,135,12,123,3.49,3870
"1875",90019,2009,248,53,195,4.57,5424
"1876",90020,2009,71,5,66,0.59,12003
"1877",90021,2009,378,0,378,1.35,28020
"1878",90022,2009,445,150,295,2.73,16324
"1879",90023,2009,345,49,296,1.75,19723
"1880",90024,2009,3596,1184,2412,7.4,48624
"1881",90025,2009,8905,3973,4932,30.68,29023
"1882",90026,2009,520,98,422,8.68,5990
"1883",90027,2009,1901,1660,241,9.14,20808
"1884",90028,2009,6855,3955,2900,30.23,22676
"1885",90029,2009,53,0,53,1.04,5085
"1886",90030,2009,0,0,0,0,283
"1887",90031,2009,318,27,291,4.3,7400
"1888",90032,2009,122,0,122,1.94,6290
"1889",90033,2009,297,0,297,1.74,17059
"1890",90034,2009,1030,305,725,12.55,8208
"1891",90035,2009,3559,3174,385,28.64,12427
"1892",90036,2009,5600,3263,2337,25.7,21791
"1893",90037,2009,121,0,121,2.06,5865
"1894",90038,2009,5152,4339,813,43.2,11925
"1895",90039,2009,504,83,421,5.66,8897
"1896",90040,2009,1773,0,1773,4.5,39382
"1897",90041,2009,310,0,310,5.15,6015
"1898",90042,2009,143,27,116,5.07,2818
"1899",90043,2009,36,0,36,1.21,2981
"1900",90044,2009,28,20,8,1.14,2449
"1901",90045,2009,3916,1365,2551,6.5,60238
"1902",90046,2009,916,308,608,7.68,11930
"1903",90047,2009,35,0,35,0.94,3712
"1904",90048,2009,5053,1182,3871,15.35,32911
"1905",90049,2009,5113,0,5113,27.45,18628
"1906",90051,2009,0,0,0,0,305
"1907",90052,2009,0,0,0,0,2656
"1908",90053,2009,0,0,0,0,3
"1909",90054,2009,0,0,0,0,437
"1910",90055,2009,0,0,0,0,46
"1911",90056,2009,392,217,175,15.05,2604
"1912",90057,2009,768,48,720,7.95,9659
"1913",90058,2009,1153,65,1088,2.82,40819
"1914",90059,2009,0,0,0,0,2899
"1915",90060,2009,0,0,0,0,64
"1916",90061,2009,73,0,73,1.38,5273
"1917",90062,2009,0,0,0,0,1427
"1918",90063,2009,113,27,86,3.29,3430
"1919",90064,2009,5858,1405,4453,28.74,20384
"1920",90065,2009,794,475,319,10.27,7731
"1921",90066,2009,3839,1218,2621,30.69,12507
"1922",90067,2009,10003,2770,7233,40.95,24428
"1923",90068,2009,1153,551,602,29.69,3884
"1924",90069,2009,2105,503,1602,13.26,15876
"1925",90070,2009,0,0,0,0,117
"1926",90071,2009,11546,309,11237,38.35,30110
"1927",90072,2009,0,0,0,0,9
"1928",90073,2009,0,0,0,0,4259
"1929",90075,2009,0,0,0,0,5
"1930",90076,2009,0,0,0,0,11
"1931",90077,2009,114,24,90,4.58,2491
"1932",90078,2009,0,0,0,0,18
"1933",90079,2009,48,0,48,4.49,1068
"1934",90080,2009,0,0,0,0,24
"1935",90082,2009,0,0,0,NA,0
"1936",90083,2009,0,0,0,0,2
"1937",90086,2009,145,0,145,10.6,1368
"1938",90087,2009,0,0,0,0,4
"1939",90089,2009,0,0,0,0,23492
"1940",90091,2009,0,0,0,0,13
"1941",90093,2009,0,0,0,0,102
"1942",90094,2009,8,0,8,0.96,830
"1943",90095,2009,173,0,173,1.98,8736
"1944",90201,2009,213,0,213,1.45,14724
"1945",90202,2009,0,0,0,0,55
"1946",90209,2009,9,9,0,2.43,370
"1947",90210,2009,2687,1287,1400,14.25,18853
"1948",90211,2009,1373,410,963,14.41,9527
"1949",90212,2009,2600,396,2204,18.39,14137
"1950",90213,2009,0,0,0,0,263
"1951",90220,2009,802,128,674,3.37,23793
"1952",90221,2009,215,55,160,1.91,11286
"1953",90222,2009,0,0,0,0,2205
"1954",90224,2009,0,0,0,0,181
"1955",90230,2009,2359,1048,1311,11.02,21397
"1956",90231,2009,0,0,0,0,8308
"1957",90232,2009,2646,719,1927,16.29,16239
"1958",90233,2009,0,0,0,0,14
"1959",90240,2009,157,0,157,3.97,3958
"1960",90241,2009,704,259,445,3.71,18969
"1961",90242,2009,453,34,419,4.3,10539
"1962",90245,2009,18481,5118,13363,31.61,58464
"1963",90247,2009,129,0,129,0.99,12971
"1964",90248,2009,1479,781,698,5.59,26470
"1965",90249,2009,83,0,83,0.94,8804
"1966",90250,2009,688,115,573,3.37,20404
"1967",90251,2009,0,0,0,0,210
"1968",90254,2009,564,156,408,9.79,5760
"1969",90255,2009,431,218,213,3.66,11770
"1970",90260,2009,275,0,275,5.55,4957
"1971",90261,2009,21,0,21,67.74,31
"1972",90262,2009,41,0,41,0.41,9944
"1973",90263,2009,0,0,0,0,1160
"1974",90264,2009,0,0,0,0,7
"1975",90265,2009,1030,330,700,15.88,6486
"1976",90266,2009,2349,540,1809,15.84,14834
"1977",90267,2009,0,0,0,0,23
"1978",90270,2009,33,0,33,1.32,2504
"1979",90272,2009,577,119,458,14.42,4002
"1980",90274,2009,533,227,306,7.77,6863
"1981",90275,2009,372,31,341,12.24,3038
"1982",90277,2009,687,115,572,7.08,9704
"1983",90278,2009,1786,214,1572,12.04,14831
"1984",90280,2009,693,126,567,4.84,14326
"1985",90290,2009,49,13,36,6.3,778
"1986",90291,2009,1875,742,1133,25.44,7370
"1987",90292,2009,1564,211,1353,13.88,11271
"1988",90293,2009,240,17,223,25.67,935
"1989",90294,2009,0,0,0,0,81
"1990",90295,2009,0,0,0,NA,0
"1991",90301,2009,262,95,167,2.02,12978
"1992",90302,2009,80,0,80,2.31,3470
"1993",90303,2009,101,32,69,2.15,4690
"1994",90304,2009,78,0,78,2.39,3258
"1995",90305,2009,8,0,8,1.33,601
"1996",90306,2009,0,0,0,0,306
"1997",90307,2009,0,0,0,0,1
"1998",90308,2009,0,0,0,0,18
"1999",90310,2009,0,0,0,0,36
"2000",90311,2009,0,0,0,0,21
"2001",90312,2009,0,0,0,0,15
"2002",90401,2009,4981,2816,2165,21.08,23632
"2003",90402,2009,180,36,144,11.71,1537
"2004",90403,2009,994,200,794,12.77,7785
"2005",90404,2009,7380,3807,3573,32.11,22981
"2006",90405,2009,3158,840,2318,20.5,15407
"2007",90406,2009,0,0,0,0,85
"2008",90407,2009,0,0,0,0,937
"2009",90408,2009,0,0,0,0,1
"2010",90409,2009,0,0,0,0,4
"2011",90410,2009,0,0,0,0,132
"2012",90411,2009,0,0,0,NA,0
"2013",90501,2009,2642,560,2082,10.4,25398
"2014",90502,2009,668,0,668,4.51,14797
"2015",90503,2009,2219,262,1957,8.3,26727
"2016",90504,2009,466,80,386,6.75,6904
"2017",90505,2009,2166,135,2031,7.75,27944
"2018",90506,2009,0,0,0,0,1155
"2019",90507,2009,0,0,0,0,71
"2020",90508,2009,0,0,0,0,8
"2021",90509,2009,41,0,41,0.68,5995
"2022",90510,2009,0,0,0,0,315
"2023",90601,2009,243,0,243,2.39,10188
"2024",90602,2009,416,8,408,5.77,7205
"2025",90603,2009,228,22,206,5.31,4290
"2026",90604,2009,39,3,36,1.75,2230
"2027",90605,2009,209,0,209,2.7,7751
"2028",90606,2009,114,40,74,2.5,4555
"2029",90607,2009,0,0,0,0,62
"2030",90608,2009,0,0,0,0,1722
"2031",90609,2009,0,0,0,0,11
"2032",90610,2009,0,0,0,0,20
"2033",90623,2009,0,0,0,0,5749
"2034",90630,2009,2217,971,1246,10.43,21255
"2035",90631,2009,426,135,291,2.95,14433
"2036",90637,2009,0,0,0,0,243
"2037",90638,2009,584,53,531,3.33,17561
"2038",90639,2009,0,0,0,0,50
"2039",90640,2009,428,118,310,2.23,19211
"2040",90650,2009,524,152,372,2.57,20402
"2041",90651,2009,0,0,0,0,115
"2042",90652,2009,0,0,0,0,1
"2043",90660,2009,446,96,350,3.37,13253
"2044",90662,2009,0,0,0,0,6
"2045",90670,2009,1805,482,1323,3.8,47468
"2046",90671,2009,0,0,0,NA,0
"2047",90701,2009,941,61,880,8.63,10902
"2048",90702,2009,0,0,0,0,725
"2049",90703,2009,1884,0,1884,7.01,26861
"2050",90704,2009,9,0,9,0.39,2298
"2051",90706,2009,235,0,235,1.86,12666
"2052",90707,2009,0,0,0,0,127
"2053",90710,2009,148,16,132,2.37,6233
"2054",90711,2009,0,0,0,0,34
"2055",90712,2009,383,215,168,3.71,10318
"2056",90713,2009,26,0,26,0.72,3624
"2057",90714,2009,0,0,0,0,1041
"2058",90715,2009,7,0,7,0.93,749
"2059",90716,2009,17,0,17,0.5,3384
"2060",90717,2009,113,20,93,3.83,2954
"2061",90723,2009,634,84,550,4.42,14349
"2062",90731,2009,945,84,861,8.95,10558
"2063",90732,2009,103,0,103,3.46,2973
"2064",90733,2009,0,0,0,0,148
"2065",90734,2009,0,0,0,0,6
"2066",90744,2009,107,27,80,1.13,9439
"2067",90745,2009,469,39,430,3.57,13149
"2068",90746,2009,817,0,817,6.37,12816
"2069",90747,2009,0,0,0,0,1877
"2070",90748,2009,0,0,0,0,428
"2071",90749,2009,0,0,0,0,1462
"2072",90755,2009,526,30,496,6.47,8131
"2073",90801,2009,160,0,160,1.38,11557
"2074",90802,2009,2993,677,2316,11.85,25265
"2075",90803,2009,529,121,408,6.14,8620
"2076",90804,2009,532,84,448,6.66,7988
"2077",90805,2009,208,6,202,1.88,11057
"2078",90806,2009,910,31,879,5.63,16174
"2079",90807,2009,1017,0,1017,7.11,14309
"2080",90808,2009,480,347,133,5.4,8883
"2081",90809,2009,0,0,0,0,1125
"2082",90810,2009,936,0,936,7.57,12358
"2083",90813,2009,227,0,227,2.12,10708
"2084",90814,2009,77,16,61,5.95,1294
"2085",90815,2009,661,241,420,6.34,10426
"2086",90822,2009,0,0,0,0,427
"2087",90831,2009,304,0,304,16.3,1865
"2088",90832,2009,0,0,0,0,38
"2089",90840,2009,0,0,0,0,4968
"2090",90846,2009,152,0,152,1.94,7854
"2091",90853,2009,0,0,0,0,4
"2092",91001,2009,327,92,235,12.4,2638
"2093",91003,2009,0,0,0,0,7
"2094",91006,2009,1033,54,979,8.38,12325
"2095",91007,2009,661,129,532,5.79,11424
"2096",91008,2009,0,0,0,0,2
"2097",91009,2009,0,0,0,0,373
"2098",91010,2009,129,8,121,1.18,10968
"2099",91011,2009,333,90,243,5.83,5715
"2100",91012,2009,0,0,0,0,3
"2101",91016,2009,1759,282,1477,11.23,15663
"2102",91017,2009,0,0,0,0,221
"2103",91020,2009,212,79,133,9.52,2226
"2104",91021,2009,0,0,0,0,32
"2105",91024,2009,79,6,73,5.05,1563
"2106",91025,2009,0,0,0,0,26
"2107",91030,2009,688,24,664,10.03,6861
"2108",91031,2009,0,0,0,0,18
"2109",91040,2009,217,90,127,10.49,2069
"2110",91041,2009,0,0,0,0,48
"2111",91042,2009,105,44,61,4.92,2133
"2112",91043,2009,0,0,0,0,23
"2113",91046,2009,0,0,0,0,26
"2114",91066,2009,0,0,0,0,149
"2115",91077,2009,0,0,0,0,5
"2116",91101,2009,3949,385,3564,16.07,24581
"2117",91102,2009,0,0,0,0,13
"2118",91103,2009,725,0,725,9.49,7641
"2119",91104,2009,237,45,192,7.78,3047
"2120",91105,2009,1278,0,1278,7.81,16359
"2121",91106,2009,827,249,578,11.2,7381
"2122",91107,2009,1455,294,1161,9.31,15628
"2123",91108,2009,182,0,182,5.85,3111
"2124",91109,2009,0,0,0,0,13290
"2125",91114,2009,0,0,0,0,6
"2126",91115,2009,0,0,0,0,11
"2127",91116,2009,0,0,0,0,15
"2128",91125,2009,0,0,0,0,71
"2129",91201,2009,698,432,266,6.36,10975
"2130",91202,2009,336,22,314,10.69,3142
"2131",91203,2009,3489,539,2950,20.4,17104
"2132",91204,2009,1233,466,767,8.8,14010
"2133",91205,2009,658,254,404,10.17,6471
"2134",91206,2009,645,79,566,7.35,8775
"2135",91207,2009,107,13,94,16.54,647
"2136",91208,2009,213,12,201,5.53,3854
"2137",91209,2009,0,0,0,0,154
"2138",91210,2009,253,106,147,5.56,4553
"2139",91214,2009,251,35,216,6.66,3766
"2140",91221,2009,0,0,0,0,249
"2141",91222,2009,0,0,0,0,15
"2142",91224,2009,0,0,0,0,6
"2143",91225,2009,0,0,0,0,5
"2144",91226,2009,0,0,0,0,1
"2145",91301,2009,2909,933,1976,22.17,13121
"2146",91302,2009,2672,728,1944,18.91,14130
"2147",91303,2009,600,181,419,5.2,11530
"2148",91304,2009,514,187,327,4.07,12629
"2149",91305,2009,0,0,0,0,225
"2150",91306,2009,177,58,119,5.55,3189
"2151",91307,2009,315,26,289,4.8,6562
"2152",91308,2009,0,0,0,0,39
"2153",91309,2009,0,0,0,0,15
"2154",91310,2009,0,0,0,0,74
"2155",91311,2009,3377,1286,2091,9.82,34389
"2156",91313,2009,0,0,0,0,321
"2157",91316,2009,1216,159,1057,16.15,7531
"2158",91321,2009,399,145,254,5.02,7943
"2159",91322,2009,0,0,0,0,308
"2160",91324,2009,882,159,723,5.54,15926
"2161",91325,2009,233,49,184,2.94,7935
"2162",91326,2009,230,21,209,7.11,3233
"2163",91327,2009,0,0,0,0,18
"2164",91328,2009,0,0,0,0,2262
"2165",91330,2009,0,0,0,0,5341
"2166",91331,2009,553,40,513,5.11,10829
"2167",91333,2009,0,0,0,0,1
"2168",91334,2009,0,0,0,0,40
"2169",91335,2009,253,96,157,3.13,8091
"2170",91337,2009,0,0,0,0,16
"2171",91340,2009,339,158,181,3.25,10425
"2172",91341,2009,0,0,0,0,275
"2173",91342,2009,343,36,307,1.79,19130
"2174",91343,2009,265,85,180,3.12,8502
"2175",91344,2009,398,83,315,5.65,7045
"2176",91345,2009,331,0,331,7.23,4575
"2177",91346,2009,0,0,0,0,1836
"2178",91350,2009,375,49,326,4.69,7999
"2179",91351,2009,427,137,290,5.75,7421
"2180",91352,2009,411,121,290,2.45,16761
"2181",91353,2009,0,0,0,0,525
"2182",91354,2009,135,20,115,9.45,1428
"2183",91355,2009,3266,810,2456,7.61,42909
"2184",91356,2009,1050,148,902,8.67,12111
"2185",91357,2009,0,0,0,0,231
"2186",91361,2009,2431,383,2048,17.81,13647
"2187",91362,2009,2714,421,2293,15.18,17877
"2188",91364,2009,1650,332,1318,10.13,16282
"2189",91365,2009,0,0,0,0,334
"2190",91367,2009,4171,1330,2841,13.55,30776
"2191",91372,2009,0,0,0,0,3
"2192",91376,2009,5,0,5,27.78,18
"2193",91380,2009,0,0,0,0,1521
"2194",91381,2009,149,17,132,4.2,3548
"2195",91383,2009,0,0,0,0,1318
"2196",91384,2009,79,0,79,4.41,1790
"2197",91385,2009,0,0,0,0,13
"2198",91386,2009,0,0,0,0,32
"2199",91387,2009,107,32,75,4.77,2244
"2200",91390,2009,61,4,57,6.49,940
"2201",91392,2009,0,0,0,0,2416
"2202",91393,2009,0,0,0,0,66
"2203",91394,2009,0,0,0,0,18
"2204",91395,2009,0,0,0,0,8
"2205",91396,2009,0,0,0,0,7
"2206",91401,2009,268,21,247,3.64,7354
"2207",91402,2009,365,131,234,3.64,10014
"2208",91403,2009,3187,1252,1935,23.27,13694
"2209",91404,2009,0,0,0,0,8
"2210",91405,2009,1413,908,505,12.35,11444
"2211",91406,2009,2000,644,1356,10.1,19803
"2212",91407,2009,0,0,0,0,2
"2213",91408,2009,0,0,0,0,76
"2214",91409,2009,0,0,0,0,810
"2215",91410,2009,0,0,0,0,11
"2216",91411,2009,933,230,703,12.4,7527
"2217",91412,2009,0,0,0,0,87
"2218",91413,2009,0,0,0,0,171
"2219",91416,2009,0,0,0,0,31
"2220",91423,2009,1509,355,1154,15.91,9485
"2221",91426,2009,0,0,0,0,17
"2222",91436,2009,5907,493,5414,36.17,16330
"2223",91501,2009,84,29,55,6.48,1296
"2224",91502,2009,19141,17687,1454,55.72,34354
"2225",91503,2009,0,0,0,0,382
"2226",91504,2009,44854,43273,1581,81.85,54797
"2227",91505,2009,6691,4580,2111,25.65,26090
"2228",91506,2009,912,353,559,12.78,7134
"2229",91507,2009,0,0,0,0,37
"2230",91508,2009,0,0,0,0,1
"2231",91510,2009,0,0,0,0,1157
"2232",91521,2009,5889,5889,0,76.93,7655
"2233",91522,2009,5839,5839,0,97.35,5998
"2234",91523,2009,880,880,0,92.05,956
"2235",91601,2009,1386,1120,266,18.28,7583
"2236",91602,2009,679,306,373,16.89,4020
"2237",91603,2009,0,0,0,0,188
"2238",91604,2009,1327,561,766,14.18,9355
"2239",91605,2009,558,247,311,3.92,14227
"2240",91606,2009,574,143,431,7.57,7586
"2241",91607,2009,483,215,268,10.92,4424
"2242",91608,2009,9272,8537,735,73.12,12681
"2243",91609,2009,0,0,0,0,19
"2244",91610,2009,0,0,0,0,10
"2245",91614,2009,0,0,0,0,21
"2246",91615,2009,0,0,0,0,168
"2247",91616,2009,0,0,0,0,43
"2248",91702,2009,255,42,213,1.63,15636
"2249",91706,2009,1296,652,644,3.94,32898
"2250",91709,2009,473,42,431,4.92,9608
"2251",91710,2009,1118,287,831,3.13,35690
"2252",91711,2009,920,51,869,7.32,12572
"2253",91714,2009,0,0,0,0,275
"2254",91715,2009,0,0,0,0,1570
"2255",91716,2009,0,0,0,0,1248
"2256",91722,2009,199,0,199,3.21,6208
"2257",91723,2009,434,159,275,4.74,9149
"2258",91724,2009,213,0,213,4.32,4930
"2259",91731,2009,832,168,664,4.84,17203
"2260",91732,2009,50,0,50,1.03,4859
"2261",91733,2009,372,42,330,2.1,17724
"2262",91734,2009,0,0,0,0,865
"2263",91740,2009,1675,129,1546,14.12,11862
"2264",91741,2009,175,4,171,4.5,3891
"2265",91744,2009,247,0,247,2.38,10376
"2266",91745,2009,1261,325,936,7.53,16737
"2267",91746,2009,349,80,269,2.25,15500
"2268",91747,2009,0,0,0,0,595
"2269",91748,2009,1234,308,926,4.76,25920
"2270",91749,2009,0,0,0,0,983
"2271",91750,2009,344,80,264,3.73,9213
"2272",91754,2009,1557,468,1089,7.6,20496
"2273",91755,2009,97,0,97,3.63,2674
"2274",91759,2009,0,0,0,0,46
"2275",91765,2009,963,95,868,8.73,11036
"2276",91766,2009,277,0,277,2.04,13565
"2277",91767,2009,281,0,281,2.38,11789
"2278",91768,2009,418,46,372,2.69,15512
"2279",91769,2009,9,0,9,0.23,3866
"2280",91770,2009,549,94,455,3.71,14789
"2281",91773,2009,746,0,746,4.03,18501
"2282",91775,2009,99,12,87,4.28,2314
"2283",91776,2009,376,21,355,3.91,9627
"2284",91778,2009,0,0,0,0,838
"2285",91780,2009,230,88,142,4.61,4988
"2286",91788,2009,0,0,0,0,333
"2287",91789,2009,942,70,872,5.32,17699
"2288",91790,2009,879,165,714,7.06,12456
"2289",91791,2009,276,0,276,3.44,8018
"2290",91792,2009,71,0,71,2.32,3062
"2291",91793,2009,0,0,0,0,108
"2292",91801,2009,518,0,518,3.42,15165
"2293",91802,2009,0,0,0,0,420
"2294",91803,2009,252,34,218,3.26,7725
"2295",91804,2009,0,0,0,0,11
"2296",92397,2009,3,0,3,0.76,394
"2297",92821,2009,1959,146,1813,6.72,29150
"2298",92823,2009,97,0,97,2.86,3393
"2299",93243,2009,0,0,0,0,1256
"2300",93510,2009,14,4,10,1.28,1091
"2301",93523,2009,243,0,243,25.39,957
"2302",93532,2009,0,0,0,0,230
"2303",93534,2009,1352,118,1234,6.05,22347
"2304",93535,2009,228,81,147,3,7600
"2305",93536,2009,66,0,66,0.65,10094
"2306",93539,2009,0,0,0,0,43
"2307",93543,2009,0,0,0,0,1094
"2308",93544,2009,0,0,0,0,147
"2309",93550,2009,609,322,287,4.03,15110
"2310",93551,2009,574,270,304,6.02,9535
"2311",93552,2009,13,0,13,0.77,1686
"2312",93553,2009,0,0,0,0,224
"2313",93560,2009,34,0,34,2.64,1286
"2314",93563,2009,0,0,0,0,66
"2315",93584,2009,0,0,0,0,29
"2316",93586,2009,0,0,0,0,6
"2317",93590,2009,0,0,0,0,203
"2318",93591,2009,0,0,0,0,331
"2319",90001,2010,31,0,31,0.34,9097
"2320",90002,2010,0,0,0,0,2010
"2321",90003,2010,47,0,47,0.76,6149
"2322",90004,2010,971,316,655,11.55,8404
"2323",90005,2010,626,340,286,12.33,5076
"2324",90006,2010,304,21,283,3.53,8601
"2325",90007,2010,377,88,289,2.82,13354
"2326",90008,2010,73,47,26,2.31,3158
"2327",90009,2010,0,0,0,0,3963
"2328",90010,2010,4844,613,4231,16.57,29235
"2329",90011,2010,49,0,49,0.53,9197
"2330",90012,2010,5055,3348,1707,3.32,152318
"2331",90013,2010,1005,156,849,7.59,13238
"2332",90014,2010,726,39,687,6.31,11503
"2333",90015,2010,1231,608,623,3.34,36815
"2334",90016,2010,1496,804,692,15.88,9418
"2335",90017,2010,12972,1512,11460,25.65,50573
"2336",90018,2010,165,15,150,3.22,5126
"2337",90019,2010,228,50,178,3.34,6836
"2338",90020,2010,131,28,103,1.05,12446
"2339",90021,2010,507,0,507,1.54,32901
"2340",90022,2010,778,329,449,4.36,17853
"2341",90023,2010,200,0,200,0.94,21354
"2342",90024,2010,4050,1224,2826,8.67,46690
"2343",90025,2010,7660,2741,4919,28.01,27346
"2344",90026,2010,580,154,426,8,7248
"2345",90027,2010,1805,1520,285,8.57,21056
"2346",90028,2010,6992,3974,3018,29.57,23648
"2347",90029,2010,99,13,86,1.79,5517
"2348",90030,2010,0,0,0,0,224
"2349",90031,2010,293,19,274,3.52,8331
"2350",90032,2010,47,0,47,0.63,7407
"2351",90033,2010,194,0,194,1.03,18784
"2352",90034,2010,953,286,667,10.69,8918
"2353",90035,2010,411,0,411,3.3,12450
"2354",90036,2010,5487,3209,2278,24.71,22204
"2355",90037,2010,131,0,131,1.95,6732
"2356",90038,2010,4784,3994,790,39.71,12047
"2357",90039,2010,459,68,391,5.21,8806
"2358",90040,2010,2517,593,1924,6.64,37883
"2359",90041,2010,226,0,226,3.45,6545
"2360",90042,2010,160,29,131,4.29,3726
"2361",90043,2010,46,0,46,1.2,3822
"2362",90044,2010,43,26,17,1.19,3606
"2363",90045,2010,3999,1317,2682,6.65,60098
"2364",90046,2010,1145,379,766,8.82,12982
"2365",90047,2010,26,0,26,0.58,4473
"2366",90048,2010,5249,1089,4160,15.68,33486
"2367",90049,2010,3246,0,3246,18.32,17716
"2368",90051,2010,0,0,0,0,260
"2369",90052,2010,0,0,0,0,2497
"2370",90053,2010,0,0,0,0,1
"2371",90054,2010,0,0,0,0,432
"2372",90055,2010,0,0,0,0,36
"2373",90056,2010,337,178,159,14.09,2392
"2374",90057,2010,525,31,494,5.14,10212
"2375",90058,2010,1369,62,1307,3.3,41517
"2376",90059,2010,8,0,8,0.23,3429
"2377",90060,2010,0,0,0,0,66
"2378",90061,2010,191,68,123,3.13,6101
"2379",90062,2010,2,0,2,0.12,1739
"2380",90063,2010,97,26,71,2.49,3902
"2381",90064,2010,8658,3961,4697,35.67,24273
"2382",90065,2010,629,387,242,6.84,9200
"2383",90066,2010,3518,1154,2364,27.87,12624
"2384",90067,2010,9656,2127,7529,39.59,24390
"2385",90068,2010,995,424,571,25.82,3854
"2386",90069,2010,2072,433,1639,13.35,15524
"2387",90070,2010,0,0,0,0,122
"2388",90071,2010,11312,289,11023,38.19,29619
"2389",90072,2010,0,0,0,0,7
"2390",90073,2010,0,0,0,0,4596
"2391",90075,2010,0,0,0,0,6
"2392",90076,2010,0,0,0,0,2
"2393",90077,2010,99,0,99,4.59,2156
"2394",90078,2010,0,0,0,0,21
"2395",90079,2010,35,0,35,3.15,1112
"2396",90080,2010,0,0,0,0,3
"2397",90082,2010,0,0,0,0,2
"2398",90083,2010,0,0,0,0,3
"2399",90086,2010,89,0,89,7.47,1192
"2400",90087,2010,0,0,0,0,5
"2401",90089,2010,0,0,0,0,24633
"2402",90091,2010,0,0,0,0,10
"2403",90093,2010,0,0,0,0,85
"2404",90094,2010,11,0,11,1.01,1087
"2405",90095,2010,151,0,151,1.71,8850
"2406",90201,2010,141,0,141,0.89,15859
"2407",90202,2010,0,0,0,0,45
"2408",90209,2010,10,10,0,32.26,31
"2409",90210,2010,2418,961,1457,13.56,17836
"2410",90211,2010,2105,488,1617,20.47,10285
"2411",90212,2010,2703,439,2264,18.53,14586
"2412",90213,2010,0,0,0,0,251
"2413",90220,2010,897,30,867,3.73,24029
"2414",90221,2010,204,63,141,1.82,11204
"2415",90222,2010,0,0,0,0,2127
"2416",90224,2010,0,0,0,0,214
"2417",90230,2010,2363,1116,1247,11.11,21267
"2418",90231,2010,0,0,0,0,8173
"2419",90232,2010,2710,782,1928,18.16,14926
"2420",90233,2010,0,0,0,0,9
"2421",90240,2010,161,0,161,4.24,3796
"2422",90241,2010,625,243,382,3.37,18541
"2423",90242,2010,224,44,180,2.15,10410
"2424",90245,2010,19414,5732,13682,32.26,60175
"2425",90247,2010,118,0,118,0.88,13446
"2426",90248,2010,1332,691,641,4.89,27234
"2427",90249,2010,138,0,138,1.42,9712
"2428",90250,2010,767,97,670,4.02,19099
"2429",90251,2010,0,0,0,0,174
"2430",90254,2010,770,307,463,13.33,5777
"2431",90255,2010,415,228,187,3.11,13358
"2432",90260,2010,218,0,218,4.63,4706
"2433",90261,2010,18,0,18,81.82,22
"2434",90262,2010,49,0,49,0.5,9707
"2435",90263,2010,0,0,0,0,1658
"2436",90264,2010,0,0,0,0,9
"2437",90265,2010,1058,316,742,16.41,6447
"2438",90266,2010,2398,470,1928,15.88,15105
"2439",90267,2010,0,0,0,0,29
"2440",90270,2010,32,0,32,1.06,3028
"2441",90272,2010,567,124,443,14.57,3891
"2442",90274,2010,638,199,439,9.27,6886
"2443",90275,2010,317,8,309,9.48,3345
"2444",90277,2010,695,83,612,7.1,9784
"2445",90278,2010,1637,218,1419,10.8,15164
"2446",90280,2010,694,92,602,3.94,17602
"2447",90290,2010,66,21,45,9.52,693
"2448",90291,2010,1911,942,969,24.64,7755
"2449",90292,2010,1739,202,1537,14.93,11647
"2450",90293,2010,243,19,224,24.82,979
"2451",90294,2010,0,0,0,0,20
"2452",90295,2010,0,0,0,NA,0
"2453",90301,2010,326,138,188,2.45,13292
"2454",90302,2010,63,0,63,1.67,3776
"2455",90303,2010,211,115,96,4.48,4707
"2456",90304,2010,64,0,64,2.05,3124
"2457",90305,2010,7,0,7,1.18,592
"2458",90306,2010,0,0,0,0,262
"2459",90307,2010,0,0,0,0,1
"2460",90308,2010,0,0,0,0,20
"2461",90310,2010,0,0,0,0,33
"2462",90311,2010,0,0,0,0,9
"2463",90312,2010,0,0,0,0,19
"2464",90401,2010,5111,2929,2182,19.99,25568
"2465",90402,2010,230,28,202,14.55,1581
"2466",90403,2010,1026,249,777,12.89,7961
"2467",90404,2010,7192,4079,3113,31.8,22615
"2468",90405,2010,3420,1162,2258,21.75,15724
"2469",90406,2010,0,0,0,0,119
"2470",90407,2010,0,0,0,0,961
"2471",90408,2010,0,0,0,0,1
"2472",90409,2010,0,0,0,0,8
"2473",90410,2010,0,0,0,0,136
"2474",90411,2010,0,0,0,NA,0
"2475",90501,2010,2514,513,2001,10.34,24321
"2476",90502,2010,730,0,730,4.77,15300
"2477",90503,2010,2229,405,1824,8.32,26801
"2478",90504,2010,558,104,454,7.46,7478
"2479",90505,2010,2133,135,1998,7.64,27936
"2480",90506,2010,0,0,0,0,1142
"2481",90507,2010,0,0,0,0,120
"2482",90508,2010,0,0,0,0,4
"2483",90509,2010,60,0,60,1.05,5733
"2484",90510,2010,0,0,0,0,272
"2485",90601,2010,271,0,271,2.62,10334
"2486",90602,2010,391,7,384,5.22,7497
"2487",90603,2010,239,31,208,6.12,3906
"2488",90604,2010,35,0,35,1.64,2130
"2489",90605,2010,212,0,212,2.74,7731
"2490",90606,2010,113,28,85,2.65,4267
"2491",90607,2010,0,0,0,0,94
"2492",90608,2010,0,0,0,0,1604
"2493",90609,2010,0,0,0,0,9
"2494",90610,2010,0,0,0,0,31
"2495",90623,2010,0,0,0,0,5361
"2496",90630,2010,2482,617,1865,12.18,20372
"2497",90631,2010,392,138,254,2.96,13258
"2498",90637,2010,0,0,0,0,202
"2499",90638,2010,864,101,763,5.82,14843
"2500",90639,2010,0,0,0,0,103
"2501",90640,2010,545,129,416,2.85,19137
"2502",90650,2010,533,153,380,2.62,20372
"2503",90651,2010,0,0,0,0,111
"2504",90652,2010,0,0,0,0,1
"2505",90660,2010,420,102,318,3.01,13948
"2506",90662,2010,0,0,0,0,6
"2507",90670,2010,1482,387,1095,3.11,47628
"2508",90701,2010,883,54,829,8.66,10197
"2509",90702,2010,0,0,0,0,554
"2510",90703,2010,1982,0,1982,7.1,27929
"2511",90704,2010,7,7,0,0.31,2295
"2512",90706,2010,532,280,252,4.16,12795
"2513",90707,2010,0,0,0,0,141
"2514",90710,2010,149,19,130,2.23,6692
"2515",90711,2010,0,0,0,0,56
"2516",90712,2010,399,218,181,3.83,10421
"2517",90713,2010,28,0,28,0.85,3304
"2518",90714,2010,0,0,0,0,1051
"2519",90715,2010,9,0,9,1.11,814
"2520",90716,2010,11,0,11,0.3,3692
"2521",90717,2010,121,20,101,3.68,3286
"2522",90723,2010,595,83,512,3.9,15261
"2523",90731,2010,811,88,723,7,11580
"2524",90732,2010,94,0,94,3.01,3122
"2525",90733,2010,0,0,0,0,75
"2526",90734,2010,0,0,0,NA,0
"2527",90744,2010,98,29,69,0.93,10539
"2528",90745,2010,282,58,224,2.01,14004
"2529",90746,2010,1090,64,1026,8.67,12576
"2530",90747,2010,63,63,0,3.44,1834
"2531",90748,2010,0,0,0,0,470
"2532",90749,2010,44,0,44,2.74,1607
"2533",90755,2010,566,35,531,6.69,8457
"2534",90801,2010,162,0,162,2.03,7988
"2535",90802,2010,2983,649,2334,12.2,24442
"2536",90803,2010,478,113,365,5.64,8468
"2537",90804,2010,513,0,513,6.57,7814
"2538",90805,2010,229,18,211,2.09,10945
"2539",90806,2010,935,14,921,5.32,17560
"2540",90807,2010,944,0,944,6.68,14129
"2541",90808,2010,526,351,175,5.66,9288
"2542",90809,2010,0,0,0,0,923
"2543",90810,2010,656,0,656,5.52,11881
"2544",90813,2010,202,0,202,1.94,10411
"2545",90814,2010,69,17,52,5.22,1321
"2546",90815,2010,586,247,339,5.02,11682
"2547",90822,2010,0,0,0,0,2763
"2548",90831,2010,312,0,312,17.11,1824
"2549",90832,2010,0,0,0,0,11
"2550",90840,2010,0,0,0,0,4576
"2551",90846,2010,76,0,76,1.05,7239
"2552",90853,2010,0,0,0,0,3
"2553",91001,2010,364,110,254,10.92,3334
"2554",91003,2010,0,0,0,0,7
"2555",91006,2010,979,48,931,7.77,12607
"2556",91007,2010,725,110,615,6.38,11370
"2557",91008,2010,0,0,0,0,20
"2558",91009,2010,0,0,0,0,344
"2559",91010,2010,73,14,59,0.62,11687
"2560",91011,2010,316,93,223,5.55,5691
"2561",91012,2010,0,0,0,0,3
"2562",91016,2010,1825,346,1479,11.65,15664
"2563",91017,2010,0,0,0,0,205
"2564",91020,2010,222,71,151,9.04,2457
"2565",91021,2010,0,0,0,0,41
"2566",91024,2010,106,7,99,7.23,1466
"2567",91025,2010,0,0,0,0,25
"2568",91030,2010,736,43,693,11.18,6581
"2569",91031,2010,0,0,0,0,9
"2570",91040,2010,227,92,135,8.74,2598
"2571",91041,2010,0,0,0,0,37
"2572",91042,2010,94,42,52,3.89,2415
"2573",91043,2010,0,0,0,0,27
"2574",91046,2010,0,0,0,0,66
"2575",91066,2010,0,0,0,0,142
"2576",91077,2010,0,0,0,0,7
"2577",91101,2010,3935,493,3442,16.61,23689
"2578",91102,2010,0,0,0,0,10
"2579",91103,2010,677,0,677,8.85,7647
"2580",91104,2010,243,50,193,8.01,3034
"2581",91105,2010,1209,0,1209,7.36,16432
"2582",91106,2010,749,147,602,10.41,7196
"2583",91107,2010,1429,229,1200,9.37,15246
"2584",91108,2010,292,0,292,9.97,2929
"2585",91109,2010,0,0,0,0,13111
"2586",91114,2010,0,0,0,0,2
"2587",91115,2010,0,0,0,0,9
"2588",91116,2010,0,0,0,0,13
"2589",91117,2010,0,0,0,0,2
"2590",91125,2010,0,0,0,0,65
"2591",91201,2010,654,405,249,6.55,9979
"2592",91202,2010,327,26,301,10.06,3250
"2593",91203,2010,3504,629,2875,21.2,16532
"2594",91204,2010,647,0,647,4.53,14282
"2595",91205,2010,681,227,454,9.96,6839
"2596",91206,2010,671,87,584,7.76,8649
"2597",91207,2010,115,0,115,17.42,660
"2598",91208,2010,224,16,208,6.3,3553
"2599",91209,2010,0,0,0,0,138
"2600",91210,2010,171,0,171,3.84,4450
"2601",91214,2010,264,9,255,7.74,3409
"2602",91221,2010,0,0,0,0,112
"2603",91222,2010,0,0,0,0,19
"2604",91224,2010,0,0,0,0,14
"2605",91225,2010,0,0,0,0,2
"2606",91226,2010,0,0,0,0,1
"2607",91301,2010,2776,934,1842,22.32,12435
"2608",91302,2010,2910,809,2101,19.4,15001
"2609",91303,2010,595,191,404,4.87,12207
"2610",91304,2010,513,174,339,4.16,12346
"2611",91305,2010,0,0,0,0,210
"2612",91306,2010,216,78,138,5.89,3666
"2613",91307,2010,14,14,0,0.2,6873
"2614",91308,2010,0,0,0,0,37
"2615",91309,2010,0,0,0,0,9
"2616",91310,2010,0,0,0,0,65
"2617",91311,2010,3174,1148,2026,9.02,35205
"2618",91313,2010,0,0,0,0,315
"2619",91316,2010,1118,197,921,14.89,7510
"2620",91321,2010,372,158,214,5.13,7248
"2621",91322,2010,0,0,0,0,294
"2622",91324,2010,563,0,563,3.3,17071
"2623",91325,2010,207,25,182,2.55,8114
"2624",91326,2010,174,34,140,4.99,3484
"2625",91327,2010,0,0,0,0,13
"2626",91328,2010,0,0,0,0,2293
"2627",91330,2010,0,0,0,0,4750
"2628",91331,2010,704,43,661,5.81,12117
"2629",91333,2010,0,0,0,0,1
"2630",91334,2010,0,0,0,0,43
"2631",91335,2010,209,86,123,2.16,9689
"2632",91337,2010,0,0,0,0,9
"2633",91340,2010,318,153,165,2.97,10717
"2634",91341,2010,0,0,0,0,254
"2635",91342,2010,337,23,314,1.74,19390
"2636",91343,2010,510,37,473,5.48,9313
"2637",91344,2010,302,16,286,3.73,8088
"2638",91345,2010,308,0,308,6.7,4594
"2639",91346,2010,0,0,0,0,1838
"2640",91350,2010,390,55,335,4.84,8053
"2641",91351,2010,442,135,307,6.23,7094
"2642",91352,2010,564,146,418,3.21,17567
"2643",91353,2010,0,0,0,0,506
"2644",91354,2010,104,3,101,7.61,1367
"2645",91355,2010,3008,769,2239,6.97,43140
"2646",91356,2010,1064,108,956,8.83,12047
"2647",91357,2010,6,6,0,1.64,366
"2648",91361,2010,2332,340,1992,17.05,13678
"2649",91362,2010,2677,427,2250,14.35,18660
"2650",91364,2010,1758,337,1421,10.37,16958
"2651",91365,2010,0,0,0,0,312
"2652",91367,2010,4212,1324,2888,13.25,31793
"2653",91372,2010,0,0,0,0,2
"2654",91376,2010,2,0,2,14.29,14
"2655",91380,2010,0,0,0,0,1402
"2656",91381,2010,198,28,170,5.68,3486
"2657",91383,2010,0,0,0,0,1356
"2658",91384,2010,74,0,74,4.22,1754
"2659",91385,2010,0,0,0,0,14
"2660",91386,2010,0,0,0,0,25
"2661",91387,2010,91,34,57,6.12,1488
"2662",91390,2010,64,14,50,6.55,977
"2663",91392,2010,0,0,0,0,2365
"2664",91393,2010,0,0,0,0,69
"2665",91394,2010,0,0,0,0,21
"2666",91395,2010,0,0,0,0,2
"2667",91396,2010,0,0,0,0,7
"2668",91401,2010,247,32,215,3.31,7463
"2669",91402,2010,388,121,267,3.46,11203
"2670",91403,2010,3306,1223,2083,23.97,13791
"2671",91404,2010,0,0,0,0,4
"2672",91405,2010,917,808,109,7.99,11484
"2673",91406,2010,1837,570,1267,8.98,20446
"2674",91407,2010,0,0,0,0,2
"2675",91408,2010,0,0,0,0,71
"2676",91409,2010,0,0,0,0,754
"2677",91410,2010,0,0,0,0,8
"2678",91411,2010,1190,224,966,13.17,9036
"2679",91412,2010,0,0,0,0,70
"2680",91413,2010,0,0,0,0,134
"2681",91416,2010,0,0,0,0,27
"2682",91423,2010,1356,274,1082,14.72,9215
"2683",91426,2010,0,0,0,0,21
"2684",91436,2010,5887,514,5373,34.41,17110
"2685",91501,2010,100,36,64,6.44,1554
"2686",91502,2010,22838,20136,2702,56.05,40744
"2687",91503,2010,0,0,0,0,360
"2688",91504,2010,45431,43947,1484,81.73,55588
"2689",91505,2010,7083,5337,1746,28.23,25088
"2690",91506,2010,1084,281,803,13.19,8218
"2691",91507,2010,0,0,0,0,46
"2692",91508,2010,0,0,0,0,1
"2693",91510,2010,235,235,0,20.17,1165
"2694",91521,2010,6010,5964,46,79.5,7560
"2695",91522,2010,5528,5528,0,97.05,5696
"2696",91523,2010,806,806,0,93.5,862
"2697",91601,2010,1584,1088,496,19.12,8286
"2698",91602,2010,618,296,322,15.02,4115
"2699",91603,2010,0,0,0,0,170
"2700",91604,2010,1364,484,880,13.77,9902
"2701",91605,2010,631,230,401,4.33,14562
"2702",91606,2010,518,139,379,6.24,8307
"2703",91607,2010,495,241,254,11.05,4481
"2704",91608,2010,9369,8636,733,72.71,12886
"2705",91609,2010,0,0,0,0,18
"2706",91610,2010,0,0,0,0,16
"2707",91614,2010,0,0,0,0,37
"2708",91615,2010,0,0,0,0,161
"2709",91616,2010,0,0,0,0,33
"2710",91617,2010,0,0,0,0,1
"2711",91702,2010,429,74,355,2.68,16026
"2712",91706,2010,1270,645,625,3.96,32055
"2713",91709,2010,602,48,554,6.01,10017
"2714",91710,2010,1345,453,892,3.81,35312
"2715",91711,2010,832,47,785,6.74,12336
"2716",91714,2010,0,0,0,0,216
"2717",91715,2010,0,0,0,0,1550
"2718",91716,2010,0,0,0,0,1256
"2719",91722,2010,175,0,175,1.89,9245
"2720",91723,2010,583,136,447,8.91,6543
"2721",91724,2010,202,24,178,4.44,4553
"2722",91731,2010,844,160,684,5.21,16190
"2723",91732,2010,96,0,96,2.02,4759
"2724",91733,2010,389,54,335,2.3,16947
"2725",91734,2010,0,0,0,0,892
"2726",91740,2010,775,132,643,7.41,10463
"2727",91741,2010,199,7,192,4.83,4124
"2728",91744,2010,206,0,206,1.72,11976
"2729",91745,2010,901,299,602,6.22,14476
"2730",91746,2010,343,88,255,2.15,15920
"2731",91747,2010,0,0,0,0,564
"2732",91748,2010,1083,249,834,4.01,26985
"2733",91749,2010,0,0,0,0,714
"2734",91750,2010,362,86,276,3.93,9207
"2735",91754,2010,1646,330,1316,8.28,19876
"2736",91755,2010,86,0,86,3.27,2631
"2737",91759,2010,0,0,0,0,74
"2738",91765,2010,869,12,857,8.05,10791
"2739",91766,2010,165,0,165,1.12,14741
"2740",91767,2010,184,0,184,1.63,11303
"2741",91768,2010,472,41,431,3.05,15495
"2742",91769,2010,0,0,0,0,3323
"2743",91770,2010,367,0,367,2.42,15141
"2744",91773,2010,688,0,688,3.96,17394
"2745",91775,2010,107,0,107,4.37,2448
"2746",91776,2010,378,22,356,3.66,10322
"2747",91778,2010,0,0,0,0,811
"2748",91780,2010,248,83,165,4.82,5141
"2749",91788,2010,0,0,0,0,274
"2750",91789,2010,1059,59,1000,5.75,18413
"2751",91790,2010,968,134,834,7.67,12624
"2752",91791,2010,285,0,285,3.64,7831
"2753",91792,2010,77,0,77,2.43,3171
"2754",91793,2010,0,0,0,0,113
"2755",91801,2010,787,275,512,5.94,13248
"2756",91802,2010,0,0,0,0,421
"2757",91803,2010,270,27,243,3.6,7509
"2758",91804,2010,0,0,0,0,12
"2759",92397,2010,3,0,3,0.77,391
"2760",92821,2010,2330,122,2208,7.83,29756
"2761",92823,2010,78,0,78,2.13,3654
"2762",93243,2010,0,0,0,0,1256
"2763",93510,2010,16,0,16,1.43,1119
"2764",93523,2010,215,0,215,32.77,656
"2765",93532,2010,0,0,0,0,191
"2766",93534,2010,1228,115,1113,5.47,22461
"2767",93535,2010,222,65,157,3.15,7057
"2768",93536,2010,81,0,81,0.83,9765
"2769",93539,2010,0,0,0,0,39
"2770",93543,2010,0,0,0,0,889
"2771",93544,2010,0,0,0,0,158
"2772",93550,2010,522,313,209,3.56,14660
"2773",93551,2010,595,265,330,5.58,10669
"2774",93552,2010,9,0,9,0.56,1608
"2775",93553,2010,0,0,0,0,219
"2776",93560,2010,41,0,41,3.28,1251
"2777",93563,2010,0,0,0,0,81
"2778",93584,2010,0,0,0,0,24
"2779",93586,2010,0,0,0,0,6
"2780",93590,2010,0,0,0,0,192
"2781",93591,2010,0,0,0,0,368
"2782",90001,2011,24,0,24,0.29,8420
"2783",90002,2011,0,0,0,0,2030
"2784",90003,2011,71,27,44,1.16,6108
"2785",90004,2011,981,310,671,11.39,8612
"2786",90005,2011,615,356,259,12.29,5006
"2787",90006,2011,316,28,288,3.98,7943
"2788",90007,2011,419,68,351,3.13,13386
"2789",90008,2011,71,39,32,2.3,3082
"2790",90009,2011,0,0,0,0,4125
"2791",90010,2011,5257,636,4621,18.27,28775
"2792",90011,2011,148,0,148,1.62,9150
"2793",90012,2011,5351,3536,1815,3.58,149414
"2794",90013,2011,1078,151,927,7.97,13521
"2795",90014,2011,792,44,748,6.8,11643
"2796",90015,2011,1528,813,715,3.93,38910
"2797",90016,2011,923,407,516,10.52,8776
"2798",90017,2011,13221,1745,11476,25.4,52041
"2799",90018,2011,154,22,132,3.15,4883
"2800",90019,2011,231,30,201,3.36,6875
"2801",90020,2011,187,36,151,1.48,12620
"2802",90021,2011,576,0,576,2.34,24613
"2803",90022,2011,851,301,550,4.67,18238
"2804",90023,2011,262,0,262,1.23,21218
"2805",90024,2011,3982,1218,2764,8.42,47298
"2806",90025,2011,7797,2287,5510,27.61,28238
"2807",90026,2011,556,127,429,7.54,7377
"2808",90027,2011,2786,2380,406,12.36,22541
"2809",90028,2011,7439,3715,3724,29.43,25279
"2810",90029,2011,94,20,74,1.66,5673
"2811",90030,2011,0,0,0,0,240
"2812",90031,2011,291,16,275,3.38,8616
"2813",90032,2011,84,0,84,1.12,7500
"2814",90033,2011,213,0,213,1.14,18711
"2815",90034,2011,1041,310,731,10.76,9677
"2816",90035,2011,424,0,424,4.25,9978
"2817",90036,2011,5528,3346,2182,23.74,23283
"2818",90037,2011,85,0,85,1.27,6684
"2819",90038,2011,4982,4049,933,40.86,12194
"2820",90039,2011,484,75,409,5.17,9367
"2821",90040,2011,2740,567,2173,7.19,38101
"2822",90041,2011,306,103,203,4.71,6500
"2823",90042,2011,161,33,128,4.29,3753
"2824",90043,2011,37,0,37,0.92,4006
"2825",90044,2011,28,14,14,0.8,3514
"2826",90045,2011,4501,1461,3040,7.37,61036
"2827",90046,2011,1243,412,831,8.92,13941
"2828",90047,2011,58,25,33,1.35,4310
"2829",90048,2011,5468,1062,4406,15.87,34453
"2830",90049,2011,3559,0,3559,19.02,18710
"2831",90051,2011,0,0,0,0,245
"2832",90052,2011,0,0,0,0,2328
"2833",90053,2011,0,0,0,0,1
"2834",90054,2011,0,0,0,0,374
"2835",90055,2011,0,0,0,0,34
"2836",90056,2011,232,172,60,10.72,2164
"2837",90057,2011,536,29,507,5.35,10020
"2838",90058,2011,1688,56,1632,3.99,42259
"2839",90059,2011,4,0,4,0.12,3313
"2840",90060,2011,0,0,0,0,67
"2841",90061,2011,125,0,125,2.02,6177
"2842",90062,2011,2,0,2,0.12,1642
"2843",90063,2011,100,21,79,2.55,3914
"2844",90064,2011,9834,4525,5309,39.2,25084
"2845",90065,2011,864,467,397,9.1,9492
"2846",90066,2011,3305,695,2610,25.75,12833
"2847",90067,2011,10084,1943,8141,39.64,25440
"2848",90068,2011,929,423,506,23.46,3960
"2849",90069,2011,2411,752,1659,14.61,16500
"2850",90070,2011,0,0,0,0,122
"2851",90071,2011,12255,363,11892,38.88,31524
"2852",90072,2011,0,0,0,0,9
"2853",90073,2011,0,0,0,0,4728
"2854",90075,2011,0,0,0,0,4
"2855",90076,2011,0,0,0,0,2
"2856",90077,2011,178,60,118,9.11,1953
"2857",90078,2011,0,0,0,0,18
"2858",90079,2011,46,0,46,4.14,1110
"2859",90080,2011,0,0,0,0,4
"2860",90082,2011,0,0,0,0,2
"2861",90083,2011,0,0,0,0,1
"2862",90086,2011,94,6,88,9.48,992
"2863",90087,2011,0,0,0,0,5
"2864",90089,2011,0,0,0,0,18781
"2865",90091,2011,0,0,0,0,11
"2866",90093,2011,0,0,0,0,82
"2867",90094,2011,7,0,7,0.51,1377
"2868",90095,2011,151,0,151,1.62,9321
"2869",90201,2011,145,0,145,0.95,15303
"2870",90202,2011,0,0,0,0,44
"2871",90209,2011,8,8,0,27.59,29
"2872",90210,2011,2623,818,1805,14.01,18723
"2873",90211,2011,2690,522,2168,25.47,10561
"2874",90212,2011,2535,425,2110,16.25,15602
"2875",90213,2011,0,0,0,0,242
"2876",90220,2011,767,20,747,3.06,25038
"2877",90221,2011,134,0,134,1.25,10723
"2878",90222,2011,7,0,7,0.32,2155
"2879",90224,2011,0,0,0,0,181
"2880",90230,2011,2703,1548,1155,12.62,21425
"2881",90231,2011,0,0,0,0,8466
"2882",90232,2011,3919,1438,2481,24.53,15974
"2883",90233,2011,0,0,0,0,7
"2884",90240,2011,163,0,163,3.82,4265
"2885",90241,2011,571,155,416,3.06,18660
"2886",90242,2011,494,35,459,4.53,10900
"2887",90245,2011,21480,6773,14707,35.03,61313
"2888",90247,2011,162,0,162,1.22,13255
"2889",90248,2011,1206,667,539,4.12,29237
"2890",90249,2011,112,0,112,1.17,9553
"2891",90250,2011,922,230,692,4.91,18791
"2892",90251,2011,0,0,0,0,125
"2893",90254,2011,762,286,476,12.58,6058
"2894",90255,2011,463,265,198,3.71,12488
"2895",90260,2011,247,8,239,4.9,5044
"2896",90261,2011,23,0,23,85.19,27
"2897",90262,2011,59,0,59,0.6,9799
"2898",90263,2011,0,0,0,0,1482
"2899",90264,2011,2,0,2,12.5,16
"2900",90265,2011,1145,300,845,17.15,6675
"2901",90266,2011,2103,578,1525,12.97,16217
"2902",90267,2011,0,0,0,0,70
"2903",90270,2011,41,0,41,1.29,3182
"2904",90272,2011,634,127,507,15.2,4170
"2905",90274,2011,607,193,414,9.24,6571
"2906",90275,2011,349,9,340,9.81,3557
"2907",90277,2011,711,94,617,7.32,9718
"2908",90278,2011,1608,203,1405,10.94,14699
"2909",90280,2011,693,95,598,3.07,22568
"2910",90290,2011,68,22,46,9.83,692
"2911",90291,2011,1967,853,1114,24.56,8009
"2912",90292,2011,1896,313,1583,15.65,12113
"2913",90293,2011,256,26,230,25.1,1020
"2914",90294,2011,0,0,0,0,15
"2915",90295,2011,0,0,0,0,3
"2916",90301,2011,296,129,167,2.23,13271
"2917",90302,2011,88,0,88,2.15,4085
"2918",90303,2011,77,3,74,1.62,4757
"2919",90304,2011,60,0,60,1.98,3027
"2920",90305,2011,9,0,9,1.58,570
"2921",90306,2011,0,0,0,0,205
"2922",90307,2011,0,0,0,0,1
"2923",90308,2011,0,0,0,0,16
"2924",90310,2011,0,0,0,0,36
"2925",90311,2011,0,0,0,0,17
"2926",90312,2011,0,0,0,0,24
"2927",90401,2011,6512,2879,3633,23.73,27441
"2928",90402,2011,316,31,285,13.41,2356
"2929",90403,2011,1034,276,758,12.67,8163
"2930",90404,2011,7192,4142,3050,30.61,23492
"2931",90405,2011,3747,1231,2516,23.45,15978
"2932",90406,2011,0,0,0,0,141
"2933",90407,2011,0,0,0,0,18
"2934",90408,2011,0,0,0,0,1
"2935",90409,2011,0,0,0,0,5
"2936",90410,2011,0,0,0,0,130
"2937",90501,2011,2470,406,2064,10.12,24417
"2938",90502,2011,958,0,958,6.09,15734
"2939",90503,2011,2237,427,1810,8.04,27816
"2940",90504,2011,524,130,394,6.3,8324
"2941",90505,2011,2326,130,2196,8.12,28632
"2942",90506,2011,0,0,0,0,1123
"2943",90507,2011,0,0,0,0,133
"2944",90508,2011,0,0,0,0,3
"2945",90509,2011,70,0,70,1.38,5055
"2946",90510,2011,0,0,0,0,266
"2947",90601,2011,314,0,314,2.9,10821
"2948",90602,2011,369,4,365,4.9,7536
"2949",90603,2011,250,27,223,6.44,3885
"2950",90604,2011,48,0,48,2.1,2283
"2951",90605,2011,206,0,206,2.72,7561
"2952",90606,2011,148,17,131,3.05,4858
"2953",90607,2011,0,0,0,0,62
"2954",90608,2011,0,0,0,0,1390
"2955",90609,2011,0,0,0,0,12
"2956",90610,2011,0,0,0,0,20
"2957",90623,2011,33,33,0,0.6,5543
"2958",90630,2011,2438,620,1818,11.77,20715
"2959",90631,2011,432,104,328,3.25,13305
"2960",90637,2011,0,0,0,0,124
"2961",90638,2011,1041,98,943,7.33,14201
"2962",90639,2011,0,0,0,0,1451
"2963",90640,2011,738,119,619,3.58,20623
"2964",90650,2011,513,159,354,2.66,19262
"2965",90651,2011,0,0,0,0,108
"2966",90652,2011,0,0,0,0,1
"2967",90660,2011,447,109,338,3.19,13997
"2968",90662,2011,0,0,0,0,7
"2969",90670,2011,1365,378,987,2.81,48509
"2970",90701,2011,966,53,913,9.52,10150
"2971",90702,2011,0,0,0,0,531
"2972",90703,2011,1867,0,1867,6.75,27639
"2973",90704,2011,5,5,0,0.21,2333
"2974",90706,2011,522,268,254,3.86,13506
"2975",90707,2011,0,0,0,0,83
"2976",90710,2011,88,20,68,1.27,6911
"2977",90711,2011,0,0,0,0,52
"2978",90712,2011,449,222,227,4.01,11189
"2979",90713,2011,35,0,35,1.19,2937
"2980",90714,2011,0,0,0,0,981
"2981",90715,2011,6,0,6,0.64,938
"2982",90716,2011,13,0,13,0.36,3573
"2983",90717,2011,133,20,113,4.09,3251
"2984",90723,2011,591,119,472,3.71,15948
"2985",90731,2011,654,83,571,5.83,11221
"2986",90732,2011,95,0,95,3.13,3039
"2987",90733,2011,0,0,0,0,68
"2988",90734,2011,0,0,0,NA,0
"2989",90744,2011,113,19,94,1.08,10462
"2990",90745,2011,248,40,208,1.81,13709
"2991",90746,2011,1075,62,1013,8.23,13067
"2992",90747,2011,65,65,0,3.17,2048
"2993",90748,2011,0,0,0,0,492
"2994",90749,2011,44,0,44,2.79,1577
"2995",90755,2011,692,31,661,8.01,8644
"2996",90801,2011,152,0,152,1.88,8074
"2997",90802,2011,2731,466,2265,10.75,25400
"2998",90803,2011,700,114,586,8.06,8685
"2999",90804,2011,580,20,560,8.13,7130
"3000",90805,2011,237,27,210,2.17,10914
"3001",90806,2011,1116,33,1083,6.28,17781
"3002",90807,2011,943,0,943,8.13,11593
"3003",90808,2011,513,255,258,5.94,8630
"3004",90809,2011,0,0,0,0,881
"3005",90810,2011,677,0,677,5.48,12360
"3006",90813,2011,215,0,215,2.06,10419
"3007",90814,2011,83,15,68,5.74,1445
"3008",90815,2011,363,0,363,3.11,11663
"3009",90822,2011,0,0,0,0,2869
"3010",90831,2011,287,0,287,17,1688
"3011",90832,2011,0,0,0,0,11
"3012",90840,2011,0,0,0,0,5039
"3013",90846,2011,3,0,3,0.05,5617
"3014",90853,2011,0,0,0,0,5
"3015",91001,2011,362,117,245,11.73,3085
"3016",91003,2011,0,0,0,0,6
"3017",91006,2011,980,57,923,7.9,12406
"3018",91007,2011,815,112,703,7.17,11372
"3019",91008,2011,0,0,0,0,27
"3020",91009,2011,0,0,0,0,413
"3021",91010,2011,107,9,98,1.02,10537
"3022",91011,2011,334,99,235,5.74,5820
"3023",91012,2011,0,0,0,0,1
"3024",91016,2011,1784,239,1545,11.38,15679
"3025",91017,2011,0,0,0,0,250
"3026",91020,2011,193,59,134,8.2,2355
"3027",91021,2011,0,0,0,0,36
"3028",91024,2011,130,7,123,7.54,1725
"3029",91025,2011,0,0,0,0,18
"3030",91030,2011,749,128,621,12.66,5915
"3031",91031,2011,0,0,0,0,7
"3032",91040,2011,220,98,122,7.97,2760
"3033",91041,2011,0,0,0,0,33
"3034",91042,2011,91,41,50,3.85,2362
"3035",91043,2011,0,0,0,0,36
"3036",91046,2011,0,0,0,0,14
"3037",91066,2011,0,0,0,0,139
"3038",91077,2011,0,0,0,0,7
"3039",91101,2011,4002,526,3476,16.85,23747
"3040",91102,2011,0,0,0,0,15
"3041",91103,2011,1628,979,649,20.37,7993
"3042",91104,2011,234,50,184,7.53,3108
"3043",91105,2011,1466,0,1466,8.82,16612
"3044",91106,2011,845,164,681,11.71,7214
"3045",91107,2011,1277,216,1061,8.25,15488
"3046",91108,2011,246,0,246,8.43,2917
"3047",91109,2011,0,0,0,0,13585
"3048",91114,2011,0,0,0,0,2
"3049",91115,2011,0,0,0,0,1
"3050",91116,2011,0,0,0,0,13
"3051",91117,2011,0,0,0,0,2
"3052",91118,2011,0,0,0,0,2
"3053",91125,2011,0,0,0,0,63
"3054",91201,2011,767,510,257,7.52,10194
"3055",91202,2011,371,40,331,10.92,3397
"3056",91203,2011,3884,727,3157,23.23,16718
"3057",91204,2011,638,0,638,4.4,14485
"3058",91205,2011,655,193,462,8.7,7528
"3059",91206,2011,687,74,613,7.28,9442
"3060",91207,2011,118,12,106,17.43,677
"3061",91208,2011,205,15,190,5.59,3664
"3062",91209,2011,0,0,0,0,129
"3063",91210,2011,272,111,161,5.94,4580
"3064",91214,2011,318,7,311,8.45,3762
"3065",91221,2011,0,0,0,0,148
"3066",91222,2011,0,0,0,0,12
"3067",91224,2011,0,0,0,0,20
"3068",91225,2011,0,0,0,0,1
"3069",91226,2011,0,0,0,0,1
"3070",91301,2011,2802,965,1837,20.52,13655
"3071",91302,2011,3075,841,2234,19.81,15520
"3072",91303,2011,556,183,373,4.56,12192
"3073",91304,2011,1027,164,863,8.33,12329
"3074",91305,2011,0,0,0,0,205
"3075",91306,2011,237,69,168,6.36,3725
"3076",91307,2011,281,35,246,4.21,6670
"3077",91308,2011,0,0,0,0,34
"3078",91309,2011,0,0,0,0,10
"3079",91310,2011,0,0,0,0,56
"3080",91311,2011,3014,951,2063,8.44,35729
"3081",91313,2011,0,0,0,0,320
"3082",91316,2011,1336,202,1134,16.99,7862
"3083",91321,2011,431,173,258,5.81,7420
"3084",91322,2011,0,0,0,0,264
"3085",91324,2011,662,0,662,3.88,17047
"3086",91325,2011,216,43,173,2.67,8089
"3087",91326,2011,220,43,177,6.21,3542
"3088",91327,2011,0,0,0,0,8
"3089",91328,2011,0,0,0,0,2252
"3090",91330,2011,0,0,0,0,5870
"3091",91331,2011,437,47,390,3.6,12149
"3092",91334,2011,0,0,0,0,13
"3093",91335,2011,325,123,202,3.42,9507
"3094",91337,2011,0,0,0,0,11
"3095",91340,2011,328,163,165,3.11,10549
"3096",91341,2011,0,0,0,0,275
"3097",91342,2011,361,57,304,1.87,19345
"3098",91343,2011,622,35,587,7.07,8794
"3099",91344,2011,340,30,310,4.19,8106
"3100",91345,2011,341,0,341,7.48,4561
"3101",91346,2011,0,0,0,0,2090
"3102",91350,2011,369,61,308,4.55,8107
"3103",91351,2011,421,127,294,6.22,6771
"3104",91352,2011,580,114,466,3.26,17792
"3105",91353,2011,0,0,0,0,523
"3106",91354,2011,114,0,114,7.55,1510
"3107",91355,2011,3119,814,2305,7.19,43374
"3108",91356,2011,1060,115,945,8.93,11870
"3109",91357,2011,5,5,0,1.28,391
"3110",91361,2011,2340,324,2016,16.29,14368
"3111",91362,2011,2130,324,1806,11.11,19164
"3112",91364,2011,1782,343,1439,10.63,16761
"3113",91365,2011,0,0,0,0,290
"3114",91367,2011,4100,1120,2980,12.89,31815
"3115",91372,2011,0,0,0,0,7
"3116",91376,2011,4,0,4,25,16
"3117",91380,2011,0,0,0,0,1477
"3118",91381,2011,214,28,186,5.86,3653
"3119",91383,2011,0,0,0,0,1198
"3120",91384,2011,76,11,65,4.42,1718
"3121",91385,2011,0,0,0,0,11
"3122",91386,2011,0,0,0,0,27
"3123",91387,2011,85,34,51,5.7,1490
"3124",91390,2011,115,12,103,11.18,1029
"3125",91392,2011,0,0,0,0,2159
"3126",91393,2011,0,0,0,0,66
"3127",91394,2011,0,0,0,0,11
"3128",91395,2011,0,0,0,0,2
"3129",91396,2011,0,0,0,0,8
"3130",91401,2011,286,38,248,3.86,7403
"3131",91402,2011,355,80,275,3.15,11266
"3132",91403,2011,3522,1131,2391,25.69,13707
"3133",91404,2011,0,0,0,0,8
"3134",91405,2011,857,746,111,7.4,11578
"3135",91406,2011,1944,729,1215,9.21,21101
"3136",91407,2011,0,0,0,0,5
"3137",91408,2011,0,0,0,0,65
"3138",91409,2011,0,0,0,0,979
"3139",91410,2011,0,0,0,0,13
"3140",91411,2011,1228,244,984,13.15,9339
"3141",91412,2011,0,0,0,0,101
"3142",91413,2011,0,0,0,0,116
"3143",91416,2011,0,0,0,0,20
"3144",91423,2011,1438,240,1198,14.55,9881
"3145",91426,2011,0,0,0,0,18
"3146",91436,2011,6415,537,5878,36.32,17663
"3147",91501,2011,75,29,46,4.4,1706
"3148",91502,2011,24865,22659,2206,57.4,43322
"3149",91503,2011,0,0,0,0,384
"3150",91504,2011,36331,34395,1936,77.12,47107
"3151",91505,2011,6718,4195,2523,26.67,25185
"3152",91506,2011,962,254,708,11.84,8125
"3153",91507,2011,0,0,0,0,54
"3154",91508,2011,0,0,0,NA,0
"3155",91510,2011,301,233,68,24.65,1221
"3156",91521,2011,6019,5912,107,77.23,7794
"3157",91522,2011,5637,5637,0,96.72,5828
"3158",91523,2011,862,862,0,93.59,921
"3159",91601,2011,1542,1043,499,17.49,8817
"3160",91602,2011,704,302,402,16.02,4394
"3161",91603,2011,0,0,0,0,161
"3162",91604,2011,1512,496,1016,14.29,10580
"3163",91605,2011,602,222,380,4.07,14786
"3164",91606,2011,467,129,338,5.85,7978
"3165",91607,2011,439,145,294,10.57,4154
"3166",91608,2011,8886,8544,342,71.19,12482
"3167",91609,2011,0,0,0,0,10
"3168",91610,2011,0,0,0,0,15
"3169",91614,2011,0,0,0,0,36
"3170",91615,2011,0,0,0,0,146
"3171",91616,2011,0,0,0,0,29
"3172",91617,2011,0,0,0,NA,0
"3173",91702,2011,473,70,403,2.96,15958
"3174",91706,2011,1204,576,628,3.64,33118
"3175",91709,2011,498,11,487,4.83,10315
"3176",91710,2011,1360,517,843,4.05,33593
"3177",91711,2011,827,42,785,6.35,13016
"3178",91714,2011,0,0,0,0,91
"3179",91715,2011,0,0,0,0,1506
"3180",91716,2011,0,0,0,0,984
"3181",91722,2011,148,0,148,1.63,9063
"3182",91723,2011,434,127,307,6.66,6521
"3183",91724,2011,270,20,250,5.2,5194
"3184",91731,2011,885,211,674,5.5,16079
"3185",91732,2011,79,0,79,1.65,4779
"3186",91733,2011,554,47,507,3.2,17321
"3187",91734,2011,0,0,0,0,854
"3188",91740,2011,1196,152,1044,11.08,10795
"3189",91741,2011,177,6,171,4.43,3993
"3190",91744,2011,275,0,275,2.43,11315
"3191",91745,2011,1077,338,739,7.58,14213
"3192",91746,2011,271,0,271,1.68,16091
"3193",91747,2011,0,0,0,0,350
"3194",91748,2011,1187,234,953,4.55,26087
"3195",91749,2011,0,0,0,0,756
"3196",91750,2011,338,62,276,3.51,9616
"3197",91754,2011,1753,306,1447,8.99,19510
"3198",91755,2011,93,0,93,3.26,2853
"3199",91759,2011,0,0,0,0,54
"3200",91765,2011,938,12,926,8.59,10925
"3201",91766,2011,163,0,163,1.1,14837
"3202",91767,2011,187,0,187,1.66,11256
"3203",91768,2011,512,63,449,3.04,16846
"3204",91769,2011,0,0,0,0,2860
"3205",91770,2011,545,82,463,3.62,15070
"3206",91773,2011,2211,1486,725,12.09,18291
"3207",91775,2011,109,7,102,4.45,2451
"3208",91776,2011,455,21,434,4.35,10468
"3209",91778,2011,0,0,0,0,906
"3210",91780,2011,233,69,164,4.45,5238
"3211",91788,2011,0,0,0,0,221
"3212",91789,2011,1026,55,971,5.47,18771
"3213",91790,2011,966,121,845,7.72,12505
"3214",91791,2011,250,0,250,3.52,7104
"3215",91792,2011,99,0,99,3.48,2841
"3216",91793,2011,0,0,0,0,96
"3217",91801,2011,962,233,729,7.01,13722
"3218",91802,2011,0,0,0,0,440
"3219",91803,2011,280,29,251,3.63,7721
"3220",91804,2011,0,0,0,0,12
"3221",92397,2011,10,0,10,2.37,422
"3222",92821,2011,2393,111,2282,7.95,30082
"3223",92823,2011,74,0,74,1.97,3747
"3224",93243,2011,0,0,0,0,1559
"3225",93510,2011,6,0,6,0.54,1111
"3226",93523,2011,329,0,329,42.4,776
"3227",93532,2011,0,0,0,0,174
"3228",93534,2011,1306,115,1191,5.92,22064
"3229",93535,2011,205,69,136,2.65,7740
"3230",93536,2011,216,102,114,2.3,9380
"3231",93539,2011,0,0,0,0,46
"3232",93543,2011,0,0,0,0,641
"3233",93544,2011,0,0,0,0,147
"3234",93550,2011,451,275,176,3.13,14393
"3235",93551,2011,598,241,357,5.42,11032
"3236",93552,2011,13,0,13,0.78,1677
"3237",93553,2011,0,0,0,0,233
"3238",93560,2011,35,0,35,2.83,1235
"3239",93563,2011,0,0,0,0,53
"3240",93584,2011,0,0,0,0,21
"3241",93586,2011,0,0,0,0,6
"3242",93590,2011,0,0,0,0,189
"3243",93591,2011,0,0,0,0,355
"3244",90001,2012,53,0,53,0.63,8421
"3245",90002,2012,0,0,0,0,1945
"3246",90003,2012,51,27,24,0.85,5989
"3247",90004,2012,1047,287,760,11.76,8902
"3248",90005,2012,475,330,145,8.64,5499
"3249",90006,2012,306,32,274,3.62,8462
"3250",90007,2012,429,125,304,3.15,13613
"3251",90008,2012,94,67,27,1.89,4980
"3252",90009,2012,0,0,0,0,4100
"3253",90010,2012,5232,674,4558,17.72,29533
"3254",90011,2012,159,18,141,1.62,9836
"3255",90012,2012,5311,3590,1721,3.57,148566
"3256",90013,2012,1153,179,974,8.41,13709
"3257",90014,2012,868,38,830,5.86,14800
"3258",90015,2012,1772,730,1042,4.4,40292
"3259",90016,2012,666,367,299,7.91,8415
"3260",90017,2012,13966,1848,12118,24.62,56731
"3261",90018,2012,152,24,128,3.16,4807
"3262",90019,2012,275,40,235,3.86,7129
"3263",90020,2012,124,33,91,1,12375
"3264",90021,2012,745,0,745,2.82,26388
"3265",90022,2012,907,307,600,5.2,17448
"3266",90023,2012,171,0,171,0.85,20039
"3267",90024,2012,3675,945,2730,7.67,47935
"3268",90025,2012,7638,2316,5322,26.59,28723
"3269",90026,2012,540,148,392,7.22,7475
"3270",90027,2012,2730,2300,430,11.63,23480
"3271",90028,2012,7366,3719,3647,27.89,26408
"3272",90029,2012,102,24,78,1.78,5739
"3273",90030,2012,0,0,0,0,249
"3274",90031,2012,265,0,265,3.14,8436
"3275",90032,2012,72,0,72,0.96,7523
"3276",90033,2012,207,0,207,1.11,18691
"3277",90034,2012,1083,322,761,10.52,10294
"3278",90035,2012,452,0,452,4.25,10635
"3279",90036,2012,5564,3305,2259,22.93,24267
"3280",90037,2012,110,0,110,1.63,6757
"3281",90038,2012,4970,3983,987,40.32,12327
"3282",90039,2012,568,86,482,6.07,9354
"3283",90040,2012,3290,542,2748,8.29,39698
"3284",90041,2012,369,103,266,5.51,6702
"3285",90042,2012,145,37,108,3.83,3789
"3286",90043,2012,28,0,28,0.73,3842
"3287",90044,2012,19,0,19,0.52,3670
"3288",90045,2012,4581,1408,3173,7.14,64178
"3289",90046,2012,1368,486,882,9.62,14223
"3290",90047,2012,78,28,50,1.8,4329
"3291",90048,2012,5783,1066,4717,16.31,35460
"3292",90049,2012,3900,0,3900,20,19501
"3293",90050,2012,0,0,0,NA,0
"3294",90051,2012,0,0,0,0,162
"3295",90052,2012,0,0,0,0,2279
"3296",90053,2012,0,0,0,0,1
"3297",90054,2012,0,0,0,0,352
"3298",90055,2012,0,0,0,0,35
"3299",90056,2012,232,174,58,9.42,2462
"3300",90057,2012,503,27,476,5.25,9589
"3301",90058,2012,1940,59,1881,4.6,42207
"3302",90059,2012,0,0,0,0,3419
"3303",90060,2012,0,0,0,0,74
"3304",90061,2012,103,24,79,1.78,5797
"3305",90062,2012,11,0,11,0.61,1810
"3306",90063,2012,103,0,103,2.72,3780
"3307",90064,2012,10890,4891,5999,42.41,25675
"3308",90065,2012,817,445,372,8.7,9394
"3309",90066,2012,3445,614,2831,26.34,13080
"3310",90067,2012,10242,1907,8335,39.95,25634
"3311",90068,2012,908,365,543,22.4,4054
"3312",90069,2012,2408,670,1738,13.56,17759
"3313",90070,2012,0,0,0,0,107
"3314",90071,2012,12366,352,12014,38.84,31838
"3315",90072,2012,0,0,0,0,11
"3316",90073,2012,0,0,0,0,4696
"3317",90076,2012,0,0,0,0,29
"3318",90077,2012,151,27,124,6.55,2306
"3319",90078,2012,0,0,0,0,18
"3320",90079,2012,46,0,46,3.71,1241
"3321",90080,2012,0,0,0,0,1
"3322",90081,2012,0,0,0,0,11
"3323",90082,2012,0,0,0,0,1
"3324",90083,2012,0,0,0,0,1
"3325",90086,2012,98,10,88,10.16,965
"3326",90087,2012,0,0,0,0,6
"3327",90089,2012,0,0,0,0,17475
"3328",90091,2012,0,0,0,0,18
"3329",90093,2012,0,0,0,0,74
"3330",90094,2012,52,0,52,3.6,1443
"3331",90095,2012,169,0,169,1.7,9943
"3332",90201,2012,148,0,148,0.96,15448
"3333",90202,2012,0,0,0,0,51
"3334",90209,2012,6,6,0,50,12
"3335",90210,2012,2786,992,1794,14.42,19325
"3336",90211,2012,3000,508,2492,26.76,11209
"3337",90212,2012,2433,401,2032,15.93,15277
"3338",90213,2012,0,0,0,0,246
"3339",90220,2012,593,0,593,2.19,27079
"3340",90221,2012,98,0,98,0.91,10747
"3341",90222,2012,0,0,0,0,2141
"3342",90224,2012,0,0,0,0,168
"3343",90230,2012,3272,2043,1229,14.36,22778
"3344",90231,2012,0,0,0,0,8491
"3345",90232,2012,4089,1495,2594,24.29,16835
"3346",90233,2012,0,0,0,0,7
"3347",90240,2012,185,16,169,3.74,4951
"3348",90241,2012,562,154,408,3.04,18460
"3349",90242,2012,356,28,328,3.31,10771
"3350",90245,2012,20152,5111,15041,32.52,61970
"3351",90247,2012,139,0,139,1.04,13413
"3352",90248,2012,1474,534,940,4.76,30943
"3353",90249,2012,203,0,203,2.13,9526
"3354",90250,2012,1037,243,794,4.98,20831
"3355",90251,2012,0,0,0,0,84
"3356",90254,2012,736,262,474,12.03,6116
"3357",90255,2012,444,290,154,3.08,14439
"3358",90260,2012,253,8,245,4.77,5302
"3359",90261,2012,22,0,22,1.5,1465
"3360",90262,2012,77,0,77,0.95,8144
"3361",90263,2012,0,0,0,0,1701
"3362",90264,2012,3,0,3,30,10
"3363",90265,2012,1287,284,1003,18.19,7075
"3364",90266,2012,2175,650,1525,13.31,16340
"3365",90267,2012,0,0,0,0,139
"3366",90270,2012,27,0,27,0.75,3595
"3367",90272,2012,757,131,626,17.64,4292
"3368",90274,2012,651,213,438,8.86,7346
"3369",90275,2012,365,20,345,9.56,3819
"3370",90277,2012,660,91,569,6.41,10300
"3371",90278,2012,1658,212,1446,11.56,14344
"3372",90280,2012,650,87,563,2.86,22690
"3373",90290,2012,64,17,47,9.73,658
"3374",90291,2012,2119,1004,1115,23.89,8868
"3375",90292,2012,1988,434,1554,16.75,11870
"3376",90293,2012,262,32,230,22.64,1157
"3377",90294,2012,0,0,0,0,3
"3378",90295,2012,0,0,0,0,2
"3379",90301,2012,335,146,189,2.56,13070
"3380",90302,2012,98,0,98,2.53,3866
"3381",90303,2012,69,0,69,1.38,4987
"3382",90304,2012,57,0,57,1.79,3176
"3383",90305,2012,0,0,0,0,731
"3384",90306,2012,0,0,0,0,195
"3385",90307,2012,0,0,0,0,1
"3386",90308,2012,0,0,0,0,16
"3387",90310,2012,0,0,0,0,116
"3388",90311,2012,0,0,0,0,17
"3389",90312,2012,0,0,0,0,29
"3390",90401,2012,6577,2970,3607,23.88,27547
"3391",90402,2012,306,0,306,15.81,1935
"3392",90403,2012,940,231,709,11.58,8119
"3393",90404,2012,7888,4557,3331,31.57,24983
"3394",90405,2012,4259,1459,2800,25.49,16708
"3395",90406,2012,0,0,0,0,192
"3396",90407,2012,0,0,0,0,19
"3397",90408,2012,0,0,0,0,8
"3398",90409,2012,0,0,0,0,6
"3399",90410,2012,0,0,0,0,36
"3400",90501,2012,2780,470,2310,12.05,23065
"3401",90502,2012,1327,0,1327,8.08,16419
"3402",90503,2012,2312,506,1806,8.03,28782
"3403",90504,2012,564,146,418,6.28,8980
"3404",90505,2012,2280,234,2046,7.7,29611
"3405",90506,2012,0,0,0,0,1538
"3406",90507,2012,0,0,0,0,120
"3407",90508,2012,0,0,0,0,2
"3408",90509,2012,39,0,39,0.72,5386
"3409",90510,2012,0,0,0,0,10
"3410",90601,2012,177,6,171,1.85,9564
"3411",90602,2012,299,0,299,3.8,7867
"3412",90603,2012,271,37,234,6.86,3949
"3413",90604,2012,44,0,44,2.04,2161
"3414",90605,2012,233,21,212,2.98,7819
"3415",90606,2012,142,0,142,2.87,4944
"3416",90607,2012,0,0,0,0,59
"3417",90608,2012,0,0,0,0,1880
"3418",90609,2012,0,0,0,0,15
"3419",90610,2012,0,0,0,0,5
"3420",90623,2012,0,0,0,0,6283
"3421",90630,2012,2136,627,1509,10.49,20359
"3422",90631,2012,980,89,891,6.29,15579
"3423",90637,2012,0,0,0,0,141
"3424",90638,2012,653,100,553,4.27,15307
"3425",90639,2012,0,0,0,0,1423
"3426",90640,2012,383,88,295,1.71,22436
"3427",90650,2012,497,167,330,2.75,18051
"3428",90651,2012,0,0,0,0,133
"3429",90652,2012,0,0,0,0,3
"3430",90660,2012,380,78,302,2.5,15221
"3431",90662,2012,0,0,0,0,8
"3432",90670,2012,1634,438,1196,3.21,50948
"3433",90701,2012,52,52,0,0.52,10043
"3434",90702,2012,0,0,0,0,521
"3435",90703,2012,3644,1907,1737,12.69,28723
"3436",90704,2012,0,0,0,0,2455
"3437",90706,2012,553,262,291,3.28,16870
"3438",90707,2012,0,0,0,0,84
"3439",90710,2012,135,14,121,1.96,6893
"3440",90711,2012,0,0,0,0,49
"3441",90712,2012,475,211,264,4.28,11098
"3442",90713,2012,48,0,48,1.55,3103
"3443",90714,2012,0,0,0,0,963
"3444",90715,2012,14,0,14,1.38,1014
"3445",90716,2012,9,0,9,0.25,3594
"3446",90717,2012,165,21,144,4.87,3387
"3447",90723,2012,644,103,541,3.8,16962
"3448",90731,2012,622,88,534,5.53,11238
"3449",90732,2012,90,8,82,2.93,3069
"3450",90733,2012,0,0,0,0,77
"3451",90734,2012,0,0,0,0,5
"3452",90744,2012,130,24,106,1.24,10443
"3453",90745,2012,316,40,276,2.31,13671
"3454",90746,2012,961,38,923,7.13,13470
"3455",90747,2012,82,82,0,3.9,2101
"3456",90748,2012,0,0,0,0,555
"3457",90749,2012,37,0,37,2.79,1328
"3458",90755,2012,687,26,661,7.28,9431
"3459",90801,2012,153,0,153,1.97,7770
"3460",90802,2012,2743,254,2489,11.2,24497
"3461",90803,2012,474,122,352,5.51,8602
"3462",90804,2012,591,10,581,7.72,7659
"3463",90805,2012,135,11,124,1.15,11755
"3464",90806,2012,1211,39,1172,7.75,15621
"3465",90807,2012,1231,0,1231,10.12,12169
"3466",90808,2012,769,486,283,8.52,9024
"3467",90809,2012,0,0,0,0,869
"3468",90810,2012,862,188,674,6.85,12577
"3469",90813,2012,261,12,249,2.44,10707
"3470",90814,2012,68,0,68,4.46,1524
"3471",90815,2012,560,0,560,4.4,12730
"3472",90822,2012,0,0,0,0,2871
"3473",90831,2012,303,0,303,17.21,1761
"3474",90832,2012,0,0,0,0,11
"3475",90840,2012,0,0,0,0,4995
"3476",90846,2012,0,0,0,0,4987
"3477",90853,2012,0,0,0,0,3
"3478",91001,2012,358,92,266,10.81,3312
"3479",91003,2012,0,0,0,0,14
"3480",91006,2012,1012,66,946,8.45,11973
"3481",91007,2012,753,125,628,6.31,11935
"3482",91008,2012,0,0,0,0,23
"3483",91009,2012,0,0,0,0,338
"3484",91010,2012,119,3,116,1.08,11013
"3485",91011,2012,333,77,256,5.68,5860
"3486",91012,2012,0,0,0,0,1
"3487",91016,2012,1608,217,1391,9.63,16706
"3488",91017,2012,0,0,0,0,240
"3489",91020,2012,327,86,241,12.24,2672
"3490",91021,2012,0,0,0,0,44
"3491",91024,2012,133,4,129,7.55,1761
"3492",91025,2012,0,0,0,0,24
"3493",91030,2012,755,98,657,12.19,6195
"3494",91031,2012,0,0,0,0,10
"3495",91040,2012,215,98,117,7.95,2705
"3496",91041,2012,0,0,0,0,36
"3497",91042,2012,164,42,122,6.76,2427
"3498",91043,2012,0,0,0,0,20
"3499",91046,2012,0,0,0,0,20
"3500",91066,2012,0,0,0,0,132
"3501",91077,2012,0,0,0,0,10
"3502",91101,2012,5091,508,4583,19.52,26076
"3503",91102,2012,0,0,0,0,15
"3504",91103,2012,1553,1008,545,19.19,8093
"3505",91104,2012,239,48,191,7.03,3401
"3506",91105,2012,2349,976,1373,15.75,14912
"3507",91106,2012,790,200,590,9.8,8061
"3508",91107,2012,1415,164,1251,8.98,15760
"3509",91108,2012,271,0,271,9.14,2965
"3510",91109,2012,0,0,0,0,13199
"3511",91114,2012,0,0,0,0,2
"3512",91115,2012,0,0,0,0,2
"3513",91116,2012,0,0,0,0,13
"3514",91117,2012,0,0,0,0,2
"3515",91118,2012,0,0,0,0,14
"3516",91125,2012,0,0,0,0,59
"3517",91201,2012,845,420,425,7.88,10730
"3518",91202,2012,418,38,380,11.26,3711
"3519",91203,2012,3811,644,3167,22.1,17247
"3520",91204,2012,625,0,625,4.26,14682
"3521",91205,2012,487,0,487,7.57,6436
"3522",91206,2012,622,85,537,6.52,9535
"3523",91207,2012,157,17,140,20.13,780
"3524",91208,2012,270,21,249,7.36,3667
"3525",91209,2012,0,0,0,0,114
"3526",91210,2012,243,96,147,5.17,4699
"3527",91214,2012,299,8,291,7.5,3985
"3528",91221,2012,0,0,0,0,142
"3529",91222,2012,0,0,0,0,13
"3530",91224,2012,0,0,0,0,4
"3531",91225,2012,0,0,0,0,1
"3532",91226,2012,0,0,0,0,1
"3533",91301,2012,2074,794,1280,15.76,13156
"3534",91302,2012,3212,840,2372,20.17,15921
"3535",91303,2012,607,178,429,4.82,12593
"3536",91304,2012,937,209,728,7.61,12308
"3537",91305,2012,0,0,0,0,225
"3538",91306,2012,237,69,168,5.91,4008
"3539",91307,2012,214,51,163,3.36,6372
"3540",91308,2012,0,0,0,0,18
"3541",91309,2012,0,0,0,0,11
"3542",91310,2012,0,0,0,0,47
"3543",91311,2012,2911,938,1973,8.09,35991
"3544",91313,2012,0,0,0,0,307
"3545",91316,2012,1041,188,853,13.75,7570
"3546",91321,2012,415,200,215,5.59,7418
"3547",91322,2012,0,0,0,0,287
"3548",91324,2012,810,0,810,4.78,16939
"3549",91325,2012,221,30,191,2.38,9294
"3550",91326,2012,238,41,197,6.75,3527
"3551",91327,2012,0,0,0,0,10
"3552",91328,2012,0,0,0,0,2065
"3553",91330,2012,0,0,0,0,6124
"3554",91331,2012,329,0,329,2.74,11988
"3555",91334,2012,0,0,0,0,12
"3556",91335,2012,305,100,205,3.16,9647
"3557",91337,2012,0,0,0,0,14
"3558",91340,2012,142,0,142,1.28,11088
"3559",91341,2012,0,0,0,0,255
"3560",91342,2012,294,0,294,1.53,19202
"3561",91343,2012,385,41,344,4.19,9186
"3562",91344,2012,301,18,283,3.68,8169
"3563",91345,2012,357,0,357,8.06,4432
"3564",91346,2012,0,0,0,0,2045
"3565",91350,2012,387,60,327,4.63,8355
"3566",91351,2012,404,120,284,5.59,7230
"3567",91352,2012,453,25,428,2.6,17425
"3568",91353,2012,0,0,0,0,484
"3569",91354,2012,111,8,103,7.72,1438
"3570",91355,2012,3003,702,2301,6.48,46316
"3571",91356,2012,1125,171,954,9.4,11962
"3572",91357,2012,0,0,0,0,449
"3573",91361,2012,2486,393,2093,16.69,14895
"3574",91362,2012,2232,191,2041,11.24,19856
"3575",91364,2012,1788,278,1510,10.36,17265
"3576",91365,2012,0,0,0,0,249
"3577",91367,2012,4415,1319,3096,13.77,32061
"3578",91372,2012,0,0,0,0,7
"3579",91376,2012,0,0,0,0,22
"3580",91380,2012,0,0,0,0,1359
"3581",91381,2012,186,27,159,4.95,3755
"3582",91383,2012,0,0,0,0,1184
"3583",91384,2012,78,0,78,4.57,1708
"3584",91385,2012,0,0,0,0,10
"3585",91386,2012,0,0,0,0,29
"3586",91387,2012,99,44,55,6.23,1590
"3587",91390,2012,94,12,82,8.93,1053
"3588",91392,2012,0,0,0,0,2034
"3589",91393,2012,0,0,0,0,73
"3590",91394,2012,0,0,0,0,9
"3591",91395,2012,0,0,0,0,3
"3592",91396,2012,0,0,0,0,8
"3593",91401,2012,375,50,325,4.89,7669
"3594",91402,2012,190,80,110,1.65,11532
"3595",91403,2012,3864,1255,2609,26.25,14721
"3596",91404,2012,0,0,0,0,7
"3597",91405,2012,848,710,138,7.4,11456
"3598",91406,2012,2075,652,1423,9.58,21666
"3599",91407,2012,0,0,0,0,54
"3600",91408,2012,0,0,0,0,113
"3601",91409,2012,0,0,0,0,1055
"3602",91410,2012,0,0,0,0,17
"3603",91411,2012,1185,240,945,12.58,9422
"3604",91412,2012,0,0,0,0,107
"3605",91413,2012,0,0,0,0,120
"3606",91416,2012,0,0,0,0,16
"3607",91423,2012,1431,210,1221,14.44,9910
"3608",91426,2012,0,0,0,0,23
"3609",91436,2012,4164,499,3665,26.49,15718
"3610",91501,2012,74,35,39,4.47,1657
"3611",91502,2012,22835,20817,2018,55.11,41437
"3612",91503,2012,0,0,0,0,402
"3613",91504,2012,37451,31954,5497,75.92,49327
"3614",91505,2012,8284,3897,4387,32.1,25804
"3615",91506,2012,953,227,726,10.91,8738
"3616",91507,2012,0,0,0,0,62
"3617",91510,2012,310,253,57,26.98,1149
"3618",91521,2012,5991,5936,55,76.41,7841
"3619",91522,2012,5158,5158,0,95.91,5378
"3620",91523,2012,862,862,0,94.1,916
"3621",91601,2012,1609,1125,484,18.07,8906
"3622",91602,2012,679,309,370,15.32,4433
"3623",91603,2012,0,0,0,0,173
"3624",91604,2012,1413,495,918,12.85,10993
"3625",91605,2012,648,177,471,4.31,15042
"3626",91606,2012,503,123,380,6.19,8122
"3627",91607,2012,493,233,260,11.78,4184
"3628",91608,2012,10367,10195,172,75.97,13647
"3629",91609,2012,0,0,0,0,9
"3630",91610,2012,0,0,0,0,19
"3631",91614,2012,0,0,0,0,27
"3632",91615,2012,0,0,0,0,143
"3633",91616,2012,0,0,0,0,29
"3634",91702,2012,651,111,540,4.21,15445
"3635",91706,2012,1212,605,607,3.82,31697
"3636",91709,2012,540,11,529,4.72,11435
"3637",91710,2012,1206,301,905,3.42,35268
"3638",91711,2012,949,44,905,6.57,14448
"3639",91714,2012,0,0,0,0,75
"3640",91715,2012,0,0,0,0,1487
"3641",91716,2012,0,0,0,0,991
"3642",91722,2012,158,0,158,1.73,9140
"3643",91723,2012,485,132,353,7.04,6888
"3644",91724,2012,496,21,475,8.46,5862
"3645",91731,2012,709,215,494,4.34,16352
"3646",91732,2012,75,0,75,1.4,5366
"3647",91733,2012,494,0,494,2.72,18133
"3648",91734,2012,0,0,0,0,868
"3649",91740,2012,1246,118,1128,11.4,10934
"3650",91741,2012,145,6,139,3.34,4347
"3651",91744,2012,440,186,254,3.68,11962
"3652",91745,2012,1112,356,756,7.4,15030
"3653",91746,2012,286,0,286,1.88,15240
"3654",91747,2012,0,0,0,0,531
"3655",91748,2012,1312,265,1047,5.19,25257
"3656",91749,2012,0,0,0,0,809
"3657",91750,2012,385,59,326,3.81,10108
"3658",91754,2012,1803,317,1486,8.76,20580
"3659",91755,2012,102,0,102,3.31,3086
"3660",91759,2012,0,0,0,0,76
"3661",91765,2012,964,54,910,8.63,11167
"3662",91766,2012,250,0,250,1.91,13107
"3663",91767,2012,263,0,263,2.17,12117
"3664",91768,2012,503,70,433,2.9,17366
"3665",91769,2012,0,0,0,0,2763
"3666",91770,2012,708,75,633,4.57,15505
"3667",91773,2012,2170,1474,696,11.69,18570
"3668",91775,2012,116,11,105,4.75,2443
"3669",91776,2012,542,27,515,5.07,10685
"3670",91778,2012,0,0,0,0,956
"3671",91780,2012,250,68,182,4.71,5305
"3672",91788,2012,0,0,0,0,202
"3673",91789,2012,1141,59,1082,5.96,19130
"3674",91790,2012,1053,295,758,8.01,13139
"3675",91791,2012,538,257,281,7.32,7353
"3676",91792,2012,112,0,112,3.78,2964
"3677",91793,2012,0,0,0,0,76
"3678",91801,2012,843,226,617,5.98,14086
"3679",91802,2012,0,0,0,0,425
"3680",91803,2012,342,21,321,4.61,7419
"3681",92397,2012,7,0,7,1.72,408
"3682",92821,2012,2627,219,2408,7.79,33744
"3683",92823,2012,75,0,75,2.14,3512
"3684",93243,2012,0,0,0,0,1755
"3685",93510,2012,10,0,10,0.83,1198
"3686",93523,2012,523,0,523,61.46,851
"3687",93532,2012,0,0,0,0,176
"3688",93534,2012,1199,83,1116,5.56,21559
"3689",93535,2012,243,101,142,3.19,7614
"3690",93536,2012,347,106,241,3.57,9711
"3691",93539,2012,0,0,0,0,42
"3692",93543,2012,0,0,0,0,633
"3693",93544,2012,0,0,0,0,136
"3694",93550,2012,684,277,407,4.68,14626
"3695",93551,2012,610,200,410,5.55,10986
"3696",93552,2012,18,0,18,0.99,1817
"3697",93553,2012,0,0,0,0,232
"3698",93560,2012,26,0,26,2.15,1212
"3699",93563,2012,0,0,0,0,47
"3700",93584,2012,0,0,0,0,22
"3701",93586,2012,0,0,0,0,4
"3702",93590,2012,0,0,0,0,169
"3703",93591,2012,0,0,0,0,333
"3704",90001,2013,103,0,103,1.14,9070
"3705",90002,2013,0,0,0,0,3042
"3706",90003,2013,58,24,34,0.81,7161
"3707",90004,2013,1001,274,727,10.48,9551
"3708",90005,2013,428,301,127,7.43,5764
"3709",90006,2013,316,35,281,3.36,9398
"3710",90007,2013,394,72,322,2.76,14272
"3711",90008,2013,104,84,20,1.67,6219
"3712",90009,2013,0,0,0,0,3918
"3713",90010,2013,5336,588,4748,18.25,29233
"3714",90011,2013,128,0,128,1.14,11216
"3715",90012,2013,3771,2262,1509,2.5,151014
"3716",90013,2013,1090,157,933,8.15,13379
"3717",90014,2013,990,44,946,6.42,15426
"3718",90015,2013,1745,759,986,4.46,39167
"3719",90016,2013,828,447,381,8.48,9760
"3720",90017,2013,15539,1983,13556,25.41,61160
"3721",90018,2013,100,13,87,1.86,5366
"3722",90019,2013,289,36,253,3.58,8062
"3723",90020,2013,129,30,99,0.99,13065
"3724",90021,2013,732,0,732,2.63,27811
"3725",90022,2013,667,303,364,3.3,20227
"3726",90023,2013,328,0,328,1.65,19857
"3727",90024,2013,3882,867,3015,8,48551
"3728",90025,2013,8318,2521,5797,26.71,31137
"3729",90026,2013,552,160,392,6.25,8838
"3730",90027,2013,1386,994,392,5.61,24714
"3731",90028,2013,7107,3594,3513,24.09,29498
"3732",90029,2013,129,26,103,1.82,7099
"3733",90030,2013,0,0,0,0,254
"3734",90031,2013,266,0,266,2.69,9872
"3735",90032,2013,71,4,67,0.83,8569
"3736",90033,2013,236,0,236,1.18,19978
"3737",90034,2013,1023,310,713,9,11363
"3738",90035,2013,393,0,393,3.28,11967
"3739",90036,2013,5711,3297,2414,22.25,25664
"3740",90037,2013,108,0,108,1.3,8278
"3741",90038,2013,4722,3854,868,37.25,12676
"3742",90039,2013,518,91,427,5.27,9824
"3743",90040,2013,2493,0,2493,6.12,40760
"3744",90041,2013,264,0,264,3.5,7549
"3745",90042,2013,147,46,101,2.94,5006
"3746",90043,2013,31,0,31,0.61,5088
"3747",90044,2013,14,0,14,0.23,6022
"3748",90045,2013,4588,1664,2924,7.08,64773
"3749",90046,2013,1451,529,922,8.69,16706
"3750",90047,2013,69,21,48,1.26,5482
"3751",90048,2013,3483,907,2576,10.35,33658
"3752",90049,2013,5813,0,5813,27.28,21312
"3753",90050,2013,0,0,0,NA,0
"3754",90051,2013,0,0,0,0,132
"3755",90052,2013,0,0,0,0,2794
"3756",90053,2013,0,0,0,0,1
"3757",90054,2013,0,0,0,0,47
"3758",90055,2013,0,0,0,0,11
"3759",90056,2013,354,293,61,12.4,2854
"3760",90057,2013,524,25,499,4.79,10939
"3761",90058,2013,1359,71,1288,3.21,42298
"3762",90059,2013,0,0,0,0,4331
"3763",90060,2013,0,0,0,0,95
"3764",90061,2013,190,29,161,2.68,7096
"3765",90062,2013,24,0,24,0.92,2601
"3766",90063,2013,118,0,118,2.37,4974
"3767",90064,2013,10619,5101,5518,40.88,25977
"3768",90065,2013,747,455,292,8.13,9187
"3769",90066,2013,3520,757,2763,26.68,13192
"3770",90067,2013,10438,1936,8502,38.07,27417
"3771",90068,2013,1004,461,543,22.81,4402
"3772",90069,2013,2609,688,1921,13.87,18811
"3773",90070,2013,0,0,0,0,2
"3774",90071,2013,10438,0,10438,31.58,33057
"3775",90072,2013,0,0,0,0,11
"3776",90073,2013,0,0,0,0,4863
"3777",90075,2013,0,0,0,0,1
"3778",90076,2013,0,0,0,0,31
"3779",90077,2013,137,23,114,5.56,2464
"3780",90078,2013,0,0,0,0,20
"3781",90079,2013,72,22,50,5.73,1256
"3782",90080,2013,0,0,0,NA,0
"3783",90081,2013,0,0,0,0,10
"3784",90082,2013,0,0,0,NA,0
"3785",90086,2013,69,11,58,5.02,1375
"3786",90087,2013,0,0,0,0,5
"3787",90089,2013,0,0,0,0,506
"3788",90091,2013,0,0,0,0,16
"3789",90093,2013,0,0,0,0,79
"3790",90094,2013,310,0,310,16.87,1838
"3791",90095,2013,175,0,175,1.69,10338
"3792",90201,2013,145,0,145,0.82,17677
"3793",90202,2013,0,0,0,0,58
"3794",90209,2013,10,10,0,76.92,13
"3795",90210,2013,3044,1302,1742,14.17,21478
"3796",90211,2013,3138,360,2778,25.55,12282
"3797",90212,2013,2595,444,2151,16.41,15818
"3798",90213,2013,0,0,0,0,174
"3799",90220,2013,608,0,608,2.02,30162
"3800",90221,2013,92,0,92,0.78,11809
"3801",90222,2013,0,0,0,0,2949
"3802",90224,2013,0,0,0,0,157
"3803",90230,2013,3707,2354,1353,13.88,26717
"3804",90231,2013,0,0,0,0,9026
"3805",90232,2013,4876,1717,3159,30.25,16117
"3806",90233,2013,0,0,0,0,8
"3807",90239,2013,0,0,0,0,11
"3808",90240,2013,249,21,228,4.11,6055
"3809",90241,2013,421,128,293,2.19,19247
"3810",90242,2013,240,27,213,1.96,12235
"3811",90245,2013,20853,5027,15826,32.92,63351
"3812",90247,2013,202,0,202,1.37,14763
"3813",90248,2013,1536,520,1016,4.88,31474
"3814",90249,2013,264,0,264,2.55,10335
"3815",90250,2013,942,192,750,4.12,22839
"3816",90251,2013,0,0,0,0,73
"3817",90254,2013,748,294,454,12.52,5974
"3818",90255,2013,334,127,207,2.23,14966
"3819",90260,2013,238,12,226,4.13,5769
"3820",90261,2013,15,0,15,1.06,1419
"3821",90262,2013,80,0,80,0.75,10629
"3822",90263,2013,0,0,0,0,1788
"3823",90264,2013,0,0,0,0,9
"3824",90265,2013,1197,193,1004,16.12,7426
"3825",90266,2013,1719,500,1219,10.32,16657
"3826",90267,2013,0,0,0,0,162
"3827",90270,2013,23,0,23,0.57,4039
"3828",90272,2013,660,138,522,15.06,4383
"3829",90274,2013,678,206,472,9.41,7204
"3830",90275,2013,363,11,352,9.1,3990
"3831",90277,2013,980,85,895,8.66,11310
"3832",90278,2013,1616,234,1382,11.12,14527
"3833",90280,2013,689,83,606,2.66,25917
"3834",90290,2013,84,24,60,10.98,765
"3835",90291,2013,2071,988,1083,21.22,9760
"3836",90292,2013,2578,608,1970,20.13,12805
"3837",90293,2013,296,28,268,23.29,1271
"3838",90294,2013,0,0,0,0,5
"3839",90295,2013,0,0,0,0,5
"3840",90301,2013,335,107,228,2.45,13650
"3841",90302,2013,99,0,99,2.33,4255
"3842",90303,2013,60,0,60,1.11,5382
"3843",90304,2013,30,0,30,0.89,3383
"3844",90305,2013,0,0,0,0,973
"3845",90306,2013,0,0,0,0,215
"3846",90307,2013,0,0,0,0,7
"3847",90308,2013,0,0,0,0,16
"3848",90310,2013,0,0,0,0,122
"3849",90311,2013,0,0,0,0,9
"3850",90312,2013,0,0,0,0,34
"3851",90401,2013,6446,3150,3296,22.8,28270
"3852",90402,2013,560,135,425,25.29,2214
"3853",90403,2013,929,181,748,10.42,8915
"3854",90404,2013,7810,4543,3267,30.61,25511
"3855",90405,2013,4150,1294,2856,24.09,17229
"3856",90406,2013,0,0,0,0,373
"3857",90407,2013,0,0,0,0,18
"3858",90408,2013,0,0,0,0,15
"3859",90409,2013,0,0,0,0,4
"3860",90410,2013,0,0,0,0,38
"3861",90501,2013,2899,471,2428,11.95,24255
"3862",90502,2013,1295,0,1295,7.83,16539
"3863",90503,2013,2408,491,1917,8.2,29377
"3864",90504,2013,563,155,408,6.54,8613
"3865",90505,2013,2228,188,2040,7.53,29575
"3866",90506,2013,0,0,0,0,1633
"3867",90507,2013,0,0,0,0,100
"3868",90508,2013,0,0,0,0,2
"3869",90509,2013,0,0,0,0,5452
"3870",90510,2013,0,0,0,0,11
"3871",90601,2013,125,0,125,1.22,10274
"3872",90602,2013,284,0,284,3.15,9029
"3873",90603,2013,271,45,226,6.44,4207
"3874",90604,2013,55,0,55,1.99,2767
"3875",90605,2013,223,8,215,2.63,8466
"3876",90606,2013,163,0,163,3.02,5401
"3877",90607,2013,0,0,0,0,55
"3878",90608,2013,0,0,0,0,2035
"3879",90609,2013,0,0,0,0,14
"3880",90610,2013,0,0,0,0,8
"3881",90623,2013,157,157,0,2.17,7225
"3882",90630,2013,2333,606,1727,11.09,21040
"3883",90631,2013,494,115,379,3.26,15167
"3884",90637,2013,0,0,0,0,143
"3885",90638,2013,580,102,478,3.88,14952
"3886",90639,2013,0,0,0,0,1455
"3887",90640,2013,605,86,519,2.61,23215
"3888",90650,2013,532,166,366,2.37,22425
"3889",90651,2013,0,0,0,0,114
"3890",90652,2013,0,0,0,0,3
"3891",90660,2013,281,0,281,1.72,16356
"3892",90662,2013,0,0,0,0,12
"3893",90670,2013,1609,330,1279,3.03,53097
"3894",90701,2013,327,0,327,3.24,10089
"3895",90702,2013,0,0,0,0,514
"3896",90703,2013,3591,1878,1713,11.93,30094
"3897",90704,2013,0,0,0,0,2427
"3898",90706,2013,315,0,315,1.72,18262
"3899",90707,2013,0,0,0,0,79
"3900",90710,2013,106,19,87,1.51,7013
"3901",90711,2013,0,0,0,0,50
"3902",90712,2013,464,200,264,3.97,11691
"3903",90713,2013,36,0,36,1.09,3297
"3904",90714,2013,0,0,0,0,1140
"3905",90715,2013,26,0,26,2.03,1280
"3906",90716,2013,0,0,0,0,3944
"3907",90717,2013,172,18,154,4.59,3748
"3908",90723,2013,681,108,573,3.92,17388
"3909",90731,2013,600,108,492,5,11991
"3910",90732,2013,108,9,99,3.29,3286
"3911",90733,2013,0,0,0,0,74
"3912",90734,2013,0,0,0,0,6
"3913",90744,2013,140,27,113,1.24,11318
"3914",90745,2013,285,28,257,2.15,13286
"3915",90746,2013,966,51,915,6.7,14425
"3916",90747,2013,0,0,0,0,2161
"3917",90748,2013,0,0,0,0,464
"3918",90749,2013,34,0,34,2.59,1312
"3919",90755,2013,890,30,860,8.74,10179
"3920",90801,2013,158,0,158,2.01,7864
"3921",90802,2013,2748,253,2495,10.53,26099
"3922",90803,2013,121,121,0,0.94,12870
"3923",90804,2013,590,20,570,7.17,8231
"3924",90805,2013,139,0,139,1.02,13648
"3925",90806,2013,1216,73,1143,7.71,15778
"3926",90807,2013,1255,0,1255,10.07,12465
"3927",90808,2013,860,500,360,8.88,9690
"3928",90809,2013,0,0,0,0,115
"3929",90810,2013,805,237,568,5.67,14208
"3930",90813,2013,260,3,257,2.17,11961
"3931",90814,2013,66,0,66,3.44,1917
"3932",90815,2013,592,0,592,4.44,13333
"3933",90822,2013,0,0,0,0,2854
"3934",90831,2013,282,0,282,17.08,1651
"3935",90832,2013,0,0,0,0,10
"3936",90840,2013,0,0,0,0,5253
"3937",90846,2013,0,0,0,0,4610
"3938",90853,2013,0,0,0,0,4
"3939",91001,2013,336,98,238,9.22,3644
"3940",91003,2013,0,0,0,0,38
"3941",91006,2013,910,76,834,7.37,12352
"3942",91007,2013,746,110,636,5.72,13048
"3943",91008,2013,0,0,0,0,34
"3944",91009,2013,0,0,0,0,332
"3945",91010,2013,105,4,101,0.89,11830
"3946",91011,2013,346,90,256,5.7,6074
"3947",91012,2013,0,0,0,0,2
"3948",91016,2013,2531,192,2339,14.61,17327
"3949",91017,2013,0,0,0,0,237
"3950",91020,2013,263,0,263,9.31,2826
"3951",91021,2013,0,0,0,0,39
"3952",91024,2013,85,8,77,4.68,1815
"3953",91025,2013,0,0,0,0,21
"3954",91030,2013,717,96,621,11.38,6300
"3955",91031,2013,0,0,0,0,8
"3956",91040,2013,137,0,137,4.05,3381
"3957",91041,2013,0,0,0,0,33
"3958",91042,2013,209,41,168,5.39,3875
"3959",91043,2013,0,0,0,0,21
"3960",91046,2013,0,0,0,0,59
"3961",91066,2013,0,0,0,0,97
"3962",91077,2013,0,0,0,0,10
"3963",91101,2013,4654,581,4073,18.96,24544
"3964",91102,2013,0,0,0,0,10
"3965",91103,2013,1756,992,764,20.34,8633
"3966",91104,2013,247,51,196,5.21,4737
"3967",91105,2013,2750,1216,1534,16.56,16607
"3968",91106,2013,625,39,586,7.21,8665
"3969",91107,2013,1618,217,1401,9.13,17727
"3970",91108,2013,259,0,259,8.4,3084
"3971",91109,2013,0,0,0,0,13030
"3972",91114,2013,0,0,0,0,2
"3973",91115,2013,0,0,0,NA,0
"3974",91116,2013,0,0,0,0,14
"3975",91117,2013,0,0,0,0,4
"3976",91118,2013,0,0,0,0,14
"3977",91125,2013,0,0,0,0,67
"3978",91201,2013,908,447,461,6.87,13216
"3979",91202,2013,485,40,445,8.57,5661
"3980",91203,2013,3918,649,3269,20.81,18823
"3981",91204,2013,584,0,584,3.66,15972
"3982",91205,2013,565,141,424,5.15,10970
"3983",91206,2013,651,121,530,5.35,12158
"3984",91207,2013,262,10,252,17.81,1471
"3985",91208,2013,274,12,262,6.75,4057
"3986",91209,2013,0,0,0,0,113
"3987",91210,2013,251,96,155,5,5017
"3988",91214,2013,296,8,288,6.41,4620
"3989",91221,2013,0,0,0,0,159
"3990",91222,2013,0,0,0,0,9
"3991",91224,2013,0,0,0,0,4
"3992",91225,2013,0,0,0,0,1
"3993",91226,2013,0,0,0,0,2
"3994",91301,2013,2191,585,1606,17.42,12577
"3995",91302,2013,3557,819,2738,21.51,16537
"3996",91303,2013,696,219,477,5.41,12868
"3997",91304,2013,877,253,624,7.19,12204
"3998",91305,2013,0,0,0,0,198
"3999",91306,2013,218,80,138,4.73,4606
"4000",91307,2013,281,89,192,4.07,6901
"4001",91308,2013,0,0,0,0,27
"4002",91309,2013,0,0,0,0,9
"4003",91310,2013,0,0,0,0,40
"4004",91311,2013,2883,873,2010,7.83,36836
"4005",91313,2013,0,0,0,0,308
"4006",91316,2013,890,196,694,10.52,8459
"4007",91321,2013,394,167,227,5.22,7549
"4008",91322,2013,0,0,0,0,285
"4009",91324,2013,690,0,690,3.84,17987
"4010",91325,2013,225,24,201,2.21,10202
"4011",91326,2013,261,37,224,6.67,3913
"4012",91327,2013,0,0,0,0,5
"4013",91328,2013,0,0,0,0,1917
"4014",91330,2013,0,0,0,0,6397
"4015",91331,2013,353,0,353,2.64,13352
"4016",91334,2013,0,0,0,0,13
"4017",91335,2013,349,128,221,2.98,11695
"4018",91337,2013,0,0,0,0,13
"4019",91340,2013,242,110,132,2.14,11311
"4020",91341,2013,0,0,0,0,270
"4021",91342,2013,255,0,255,1.26,20203
"4022",91343,2013,275,41,234,2.73,10062
"4023",91344,2013,307,33,274,3.3,9289
"4024",91345,2013,323,0,323,6.65,4859
"4025",91346,2013,0,0,0,0,1962
"4026",91350,2013,372,76,296,4.33,8601
"4027",91351,2013,438,130,308,5.83,7509
"4028",91352,2013,549,54,495,2.92,18818
"4029",91353,2013,0,0,0,0,569
"4030",91354,2013,122,5,117,7.78,1568
"4031",91355,2013,3133,613,2520,6.44,48677
"4032",91356,2013,1139,146,993,9.12,12491
"4033",91357,2013,0,0,0,0,447
"4034",91361,2013,2750,354,2396,18.48,14882
"4035",91362,2013,2121,159,1962,10.52,20160
"4036",91364,2013,1896,303,1593,10.84,17487
"4037",91365,2013,0,0,0,0,246
"4038",91367,2013,4795,1210,3585,13.92,34446
"4039",91372,2013,0,0,0,0,8
"4040",91376,2013,0,0,0,0,13
"4041",91380,2013,0,0,0,0,1288
"4042",91381,2013,223,47,176,5.39,4137
"4043",91383,2013,0,0,0,0,1191
"4044",91384,2013,64,0,64,3.4,1883
"4045",91385,2013,0,0,0,0,11
"4046",91386,2013,0,0,0,0,29
"4047",91387,2013,99,23,76,5.14,1926
"4048",91390,2013,82,15,67,6.25,1313
"4049",91392,2013,0,0,0,0,1810
"4050",91393,2013,0,0,0,0,75
"4051",91394,2013,0,0,0,0,12
"4052",91395,2013,0,0,0,0,2
"4053",91396,2013,0,0,0,0,8
"4054",91401,2013,495,33,462,5.35,9250
"4055",91402,2013,184,71,113,1.38,13358
"4056",91403,2013,3566,1208,2358,22.85,15608
"4057",91404,2013,0,0,0,0,9
"4058",91405,2013,951,812,139,7.2,13210
"4059",91406,2013,1839,627,1212,7.96,23110
"4060",91407,2013,0,0,0,0,35
"4061",91408,2013,0,0,0,0,87
"4062",91409,2013,0,0,0,0,1044
"4063",91410,2013,0,0,0,0,16
"4064",91411,2013,1193,245,948,11.73,10171
"4065",91412,2013,0,0,0,0,98
"4066",91413,2013,0,0,0,0,187
"4067",91416,2013,0,0,0,0,24
"4068",91423,2013,1612,202,1410,14.89,10823
"4069",91426,2013,0,0,0,0,16
"4070",91436,2013,4267,513,3754,26.07,16365
"4071",91501,2013,94,38,56,3.77,2495
"4072",91502,2013,22131,14257,7874,54.56,40564
"4073",91503,2013,0,0,0,0,400
"4074",91504,2013,43328,36577,6751,75.98,57028
"4075",91505,2013,8788,3701,5087,33.26,26421
"4076",91506,2013,833,250,583,9.55,8724
"4077",91507,2013,0,0,0,0,44
"4078",91510,2013,0,0,0,0,1124
"4079",91521,2013,6268,6210,58,75.16,8340
"4080",91522,2013,5483,5483,0,95.62,5734
"4081",91523,2013,668,668,0,94.75,705
"4082",91601,2013,1618,1100,518,15.87,10193
"4083",91602,2013,692,266,426,14.24,4858
"4084",91603,2013,0,0,0,0,164
"4085",91604,2013,1232,458,774,11.08,11120
"4086",91605,2013,633,166,467,3.7,17093
"4087",91606,2013,522,116,406,5.12,10191
"4088",91607,2013,542,297,245,10.78,5030
"4089",91608,2013,11629,11488,141,77.46,15013
"4090",91609,2013,0,0,0,0,13
"4091",91610,2013,0,0,0,0,37
"4092",91614,2013,0,0,0,0,21
"4093",91615,2013,0,0,0,0,152
"4094",91616,2013,0,0,0,0,34
"4095",91617,2013,0,0,0,0,4
"4096",91702,2013,599,135,464,3.6,16631
"4097",91706,2013,1272,658,614,3.84,33139
"4098",91709,2013,621,12,609,5.15,12065
"4099",91710,2013,1419,303,1116,3.87,36666
"4100",91711,2013,931,30,901,6.67,13950
"4101",91714,2013,0,0,0,0,76
"4102",91715,2013,0,0,0,0,1672
"4103",91716,2013,0,0,0,0,1085
"4104",91722,2013,181,0,181,2.3,7872
"4105",91723,2013,396,113,283,5.8,6829
"4106",91724,2013,425,0,425,6.42,6620
"4107",91731,2013,737,258,479,4.25,17335
"4108",91732,2013,167,0,167,2.63,6339
"4109",91733,2013,611,0,611,3.15,19377
"4110",91734,2013,0,0,0,0,973
"4111",91740,2013,1183,98,1085,10.62,11142
"4112",91741,2013,116,6,110,2.5,4638
"4113",91744,2013,214,0,214,1.62,13206
"4114",91745,2013,1191,344,847,7.35,16195
"4115",91746,2013,490,184,306,3.02,16245
"4116",91747,2013,0,0,0,0,522
"4117",91748,2013,1360,281,1079,4.87,27923
"4118",91749,2013,0,0,0,0,838
"4119",91750,2013,441,58,383,4.01,11010
"4120",91754,2013,1985,324,1661,9.21,21555
"4121",91755,2013,117,3,114,2.87,4077
"4122",91759,2013,0,0,0,0,77
"4123",91765,2013,973,44,929,7.68,12665
"4124",91766,2013,191,0,191,1.31,14576
"4125",91767,2013,221,0,221,1.74,12733
"4126",91768,2013,462,74,388,2.61,17684
"4127",91769,2013,0,0,0,0,2653
"4128",91770,2013,510,93,417,3,17027
"4129",91773,2013,2460,1697,763,13.38,18379
"4130",91775,2013,129,13,116,4.25,3036
"4131",91776,2013,614,34,580,5.25,11692
"4132",91778,2013,0,0,0,0,976
"4133",91780,2013,268,63,205,4.38,6113
"4134",91788,2013,0,0,0,0,182
"4135",91789,2013,1046,57,989,5.09,20552
"4136",91790,2013,1117,325,792,7.48,14932
"4137",91791,2013,525,294,231,6.88,7633
"4138",91792,2013,106,0,106,2.86,3700
"4139",91793,2013,0,0,0,0,68
"4140",91801,2013,755,205,550,4.78,15802
"4141",91802,2013,0,0,0,0,422
"4142",91803,2013,630,38,592,7.21,8736
"4143",92397,2013,8,0,8,1.58,506
"4144",92821,2013,3008,211,2797,8.31,36217
"4145",92823,2013,72,0,72,2.02,3568
"4146",93243,2013,0,0,0,0,1819
"4147",93510,2013,14,0,14,1.05,1339
"4148",93523,2013,491,0,491,56.63,867
"4149",93532,2013,0,0,0,0,198
"4150",93534,2013,1067,88,979,4.56,23409
"4151",93535,2013,243,92,151,2.79,8718
"4152",93536,2013,268,118,150,2.64,10148
"4153",93539,2013,0,0,0,0,53
"4154",93543,2013,0,0,0,0,813
"4155",93544,2013,0,0,0,0,193
"4156",93550,2013,630,240,390,3.91,16122
"4157",93551,2013,509,254,255,4.28,11899
"4158",93552,2013,5,0,5,0.21,2391
"4159",93553,2013,0,0,0,0,254
"4160",93560,2013,37,0,37,2.76,1341
"4161",93563,2013,0,0,0,0,45
"4162",93584,2013,0,0,0,0,29
"4163",93586,2013,0,0,0,0,5
"4164",93590,2013,0,0,0,0,191
"4165",93591,2013,0,0,0,0,419
"4166",90001,2014,88,0,88,0.97,9055
"4167",90002,2014,0,0,0,0,3048
"4168",90003,2014,37,0,37,0.51,7228
"4169",90004,2014,1005,308,697,8.44,11901
"4170",90005,2014,670,287,383,11.11,6028
"4171",90006,2014,319,41,278,3.36,9483
"4172",90007,2014,344,28,316,2.39,14419
"4173",90008,2014,121,85,36,2,6063
"4174",90009,2014,0,0,0,0,4282
"4175",90010,2014,5424,545,4879,17.15,31634
"4176",90011,2014,112,0,112,0.97,11566
"4177",90012,2014,3476,1889,1587,2.3,151366
"4178",90013,2014,1140,175,965,7.25,15729
"4179",90014,2014,1032,26,1006,8.27,12477
"4180",90015,2014,1959,919,1040,4.5,43523
"4181",90016,2014,956,533,423,9.5,10067
"4182",90017,2014,15393,2000,13393,24.55,62713
"4183",90018,2014,89,8,81,1.62,5492
"4184",90019,2014,321,46,275,3.91,8214
"4185",90020,2014,162,40,122,1.21,13388
"4186",90021,2014,1071,329,742,3.75,28596
"4187",90022,2014,666,315,351,3.51,18971
"4188",90023,2014,635,88,547,3.23,19645
"4189",90024,2014,3828,726,3102,8.11,47228
"4190",90025,2014,9043,2798,6245,27.61,32753
"4191",90026,2014,571,151,420,6.48,8805
"4192",90027,2014,1204,646,558,4.86,24758
"4193",90028,2014,6749,3610,3139,23.06,29271
"4194",90029,2014,110,19,91,1.54,7122
"4195",90030,2014,0,0,0,0,254
"4196",90031,2014,256,0,256,2.25,11353
"4197",90032,2014,110,5,105,1.11,9900
"4198",90033,2014,192,0,192,0.95,20303
"4199",90034,2014,1062,358,704,9.1,11674
"4200",90035,2014,3651,3227,424,29.9,12210
"4201",90036,2014,6083,3523,2560,22.07,27557
"4202",90037,2014,100,18,82,1.15,8729
"4203",90038,2014,4892,4010,882,37.2,13152
"4204",90039,2014,563,66,497,5.6,10048
"4205",90040,2014,2360,0,2360,5.36,44015
"4206",90041,2014,414,129,285,5.28,7845
"4207",90042,2014,157,59,98,3.13,5012
"4208",90043,2014,34,12,22,0.55,6195
"4209",90044,2014,0,0,0,0,6624
"4210",90045,2014,4355,1710,2645,6.71,64949
"4211",90046,2014,1648,591,1057,9.68,17021
"4212",90047,2014,89,22,67,1.57,5683
"4213",90048,2014,3116,678,2438,8.42,36989
"4214",90049,2014,2836,0,2836,16.41,17283
"4215",90050,2014,0,0,0,0,1
"4216",90051,2014,0,0,0,0,117
"4217",90052,2014,0,0,0,0,2786
"4218",90053,2014,0,0,0,0,1
"4219",90054,2014,0,0,0,0,11
"4220",90055,2014,0,0,0,0,4
"4221",90056,2014,272,272,0,10.06,2704
"4222",90057,2014,492,39,453,4.52,10886
"4223",90058,2014,1431,36,1395,3.4,42067
"4224",90059,2014,0,0,0,0,4104
"4225",90060,2014,0,0,0,0,50
"4226",90061,2014,197,28,169,3.07,6427
"4227",90062,2014,33,0,33,1.2,2749
"4228",90063,2014,153,37,116,2.65,5763
"4229",90064,2014,10797,5087,5710,40.7,26525
"4230",90065,2014,783,463,320,8.45,9268
"4231",90066,2014,3616,867,2749,26.82,13480
"4232",90067,2014,10384,1914,8470,37.13,27965
"4233",90068,2014,948,436,512,21.31,4449
"4234",90069,2014,2688,641,2047,13.8,19474
"4235",90070,2014,0,0,0,0,3
"4236",90071,2014,10705,0,10705,34.63,30912
"4237",90072,2014,0,0,0,0,10
"4238",90073,2014,0,0,0,0,4766
"4239",90075,2014,0,0,0,0,1
"4240",90076,2014,0,0,0,0,34
"4241",90077,2014,132,38,94,6.61,1998
"4242",90078,2014,0,0,0,0,23
"4243",90079,2014,80,26,54,6.66,1202
"4244",90081,2014,0,0,0,0,1
"4245",90086,2014,0,0,0,0,1490
"4246",90087,2014,0,0,0,0,5
"4247",90089,2014,0,0,0,0,18493
"4248",90091,2014,0,0,0,0,20
"4249",90093,2014,0,0,0,0,77
"4250",90094,2014,376,0,376,22.08,1703
"4251",90095,2014,179,0,179,1.75,10247
"4252",90201,2014,188,0,188,1.15,16393
"4253",90202,2014,0,0,0,0,72
"4254",90209,2014,5,5,0,45.45,11
"4255",90210,2014,3160,1454,1706,13.59,23260
"4256",90211,2014,3319,1446,1873,25.47,13030
"4257",90212,2014,2652,471,2181,15.98,16597
"4258",90213,2014,0,0,0,0,169
"4259",90220,2014,694,0,694,2.16,32070
"4260",90221,2014,238,83,155,2.03,11703
"4261",90222,2014,0,0,0,0,3116
"4262",90224,2014,18,0,18,10.53,171
"4263",90230,2014,4423,2743,1680,15.06,29362
"4264",90231,2014,0,0,0,0,8653
"4265",90232,2014,5736,1424,4312,33.33,17208
"4266",90233,2014,0,0,0,0,7
"4267",90239,2014,0,0,0,0,113
"4268",90240,2014,256,28,228,5.02,5099
"4269",90241,2014,440,154,286,2.4,18327
"4270",90242,2014,241,35,206,2.1,11492
"4271",90245,2014,20477,4842,15635,32.41,63183
"4272",90247,2014,405,268,137,2.73,14849
"4273",90248,2014,1444,387,1057,4.41,32738
"4274",90249,2014,145,0,145,1.41,10265
"4275",90250,2014,931,196,735,4.03,23086
"4276",90251,2014,0,0,0,0,77
"4277",90254,2014,681,260,421,10.57,6440
"4278",90255,2014,381,133,248,2.54,15011
"4279",90260,2014,234,17,217,3.94,5941
"4280",90261,2014,12,0,12,0.85,1406
"4281",90262,2014,125,33,92,1.1,11322
"4282",90263,2014,0,0,0,0,1733
"4283",90264,2014,0,0,0,0,12
"4284",90265,2014,1224,185,1039,15.57,7863
"4285",90266,2014,1932,470,1462,11.14,17344
"4286",90267,2014,0,0,0,0,36
"4287",90270,2014,24,0,24,0.54,4413
"4288",90272,2014,797,238,559,16.1,4951
"4289",90274,2014,689,202,487,9.94,6934
"4290",90275,2014,357,7,350,6.93,5150
"4291",90277,2014,976,117,859,8.37,11663
"4292",90278,2014,1360,172,1188,9.45,14396
"4293",90280,2014,773,112,661,2.84,27260
"4294",90290,2014,78,33,45,9.82,794
"4295",90291,2014,2130,987,1143,20.34,10470
"4296",90292,2014,2257,267,1990,17.33,13023
"4297",90293,2014,253,27,226,18.33,1380
"4298",90294,2014,0,0,0,0,4
"4299",90295,2014,0,0,0,0,4
"4300",90301,2014,366,112,254,2.44,14997
"4301",90302,2014,84,0,84,1.88,4473
"4302",90303,2014,56,0,56,1,5628
"4303",90304,2014,54,0,54,1.6,3373
"4304",90305,2014,0,0,0,0,1054
"4305",90306,2014,0,0,0,0,57
"4306",90307,2014,0,0,0,0,7
"4307",90308,2014,0,0,0,0,16
"4308",90310,2014,0,0,0,0,132
"4309",90311,2014,0,0,0,0,9
"4310",90312,2014,0,0,0,0,46
"4311",90401,2014,6399,2724,3675,22.44,28512
"4312",90402,2014,552,136,416,24.14,2287
"4313",90403,2014,1073,186,887,12.07,8890
"4314",90404,2014,8888,5656,3232,31.79,27956
"4315",90405,2014,4205,1432,2773,24.13,17425
"4316",90406,2014,0,0,0,0,344
"4317",90407,2014,0,0,0,0,18
"4318",90408,2014,0,0,0,0,21
"4319",90409,2014,0,0,0,0,5
"4320",90410,2014,0,0,0,0,66
"4321",90501,2014,2881,358,2523,11.48,25090
"4322",90502,2014,1295,0,1295,7.88,16424
"4323",90503,2014,2443,680,1763,7.93,30812
"4324",90504,2014,497,191,306,5.57,8928
"4325",90505,2014,2248,157,2091,7.64,29438
"4326",90506,2014,0,0,0,0,1689
"4327",90507,2014,0,0,0,0,60
"4328",90509,2014,72,0,72,1.29,5561
"4329",90510,2014,0,0,0,0,14
"4330",90601,2014,133,0,133,1.18,11247
"4331",90602,2014,276,0,276,2.98,9276
"4332",90603,2014,249,35,214,5.62,4433
"4333",90604,2014,48,0,48,1.8,2664
"4334",90605,2014,190,8,182,2.4,7924
"4335",90606,2014,141,0,141,2.44,5768
"4336",90607,2014,0,0,0,0,51
"4337",90608,2014,0,0,0,0,1965
"4338",90609,2014,0,0,0,0,15
"4339",90610,2014,0,0,0,0,4
"4340",90623,2014,214,214,0,3.25,6577
"4341",90630,2014,2327,708,1619,10.74,21675
"4342",90631,2014,470,113,357,2.96,15853
"4343",90637,2014,0,0,0,0,128
"4344",90638,2014,524,93,431,3.28,15971
"4345",90639,2014,0,0,0,0,1413
"4346",90640,2014,509,92,417,2.16,23602
"4347",90650,2014,559,146,413,2.53,22118
"4348",90651,2014,0,0,0,0,113
"4349",90652,2014,0,0,0,0,2
"4350",90660,2014,330,95,235,1.96,16799
"4351",90662,2014,0,0,0,0,11
"4352",90670,2014,1585,299,1286,2.91,54401
"4353",90701,2014,184,45,139,1.91,9638
"4354",90702,2014,0,0,0,0,501
"4355",90703,2014,3063,1788,1275,10.08,30374
"4356",90704,2014,0,0,0,0,2577
"4357",90706,2014,268,0,268,1.51,17782
"4358",90707,2014,0,0,0,0,72
"4359",90710,2014,128,20,108,1.77,7235
"4360",90711,2014,0,0,0,0,52
"4361",90712,2014,508,189,319,4.6,11043
"4362",90713,2014,41,0,41,1.22,3357
"4363",90714,2014,0,0,0,0,1157
"4364",90715,2014,46,0,46,3.4,1353
"4365",90716,2014,0,0,0,0,3890
"4366",90717,2014,168,18,150,4.56,3683
"4367",90723,2014,477,104,373,2.79,17110
"4368",90731,2014,596,98,498,4.86,12259
"4369",90732,2014,93,8,85,2.99,3109
"4370",90733,2014,0,0,0,0,84
"4371",90734,2014,0,0,0,0,6
"4372",90744,2014,198,55,143,1.71,11591
"4373",90745,2014,347,29,318,2.45,14136
"4374",90746,2014,980,83,897,6.72,14581
"4375",90747,2014,0,0,0,0,2218
"4376",90748,2014,0,0,0,0,338
"4377",90749,2014,27,0,27,2.07,1305
"4378",90755,2014,505,26,479,4.79,10551
"4379",90801,2014,35,0,35,0.44,8043
"4380",90802,2014,3152,297,2855,12.51,25196
"4381",90803,2014,798,124,674,8.45,9439
"4382",90804,2014,615,14,601,6.97,8829
"4383",90805,2014,152,0,152,1.11,13653
"4384",90806,2014,1159,44,1115,7.79,14875
"4385",90807,2014,1240,0,1240,9.84,12599
"4386",90808,2014,1365,456,909,12.39,11015
"4387",90809,2014,0,0,0,0,166
"4388",90810,2014,763,208,555,5.26,14499
"4389",90813,2014,264,0,264,2.14,12355
"4390",90814,2014,56,0,56,3.07,1823
"4391",90815,2014,614,0,614,4.52,13598
"4392",90822,2014,0,0,0,0,2948
"4393",90831,2014,258,0,258,19.77,1305
"4394",90832,2014,0,0,0,0,17
"4395",90840,2014,0,0,0,0,5690
"4396",90846,2014,4,0,4,0.1,3915
"4397",90853,2014,0,0,0,0,5
"4398",91001,2014,384,73,311,10.45,3675
"4399",91003,2014,0,0,0,0,29
"4400",91006,2014,980,109,871,6.76,14493
"4401",91007,2014,687,109,578,5.15,13349
"4402",91008,2014,0,0,0,0,50
"4403",91009,2014,0,0,0,0,318
"4404",91010,2014,113,7,106,0.96,11829
"4405",91011,2014,321,107,214,5.07,6331
"4406",91012,2014,0,0,0,0,3
"4407",91016,2014,2347,174,2173,13.4,17515
"4408",91017,2014,0,0,0,0,255
"4409",91020,2014,242,0,242,8.81,2746
"4410",91021,2014,0,0,0,0,52
"4411",91024,2014,69,5,64,3.89,1776
"4412",91025,2014,0,0,0,0,19
"4413",91030,2014,669,100,569,10.45,6399
"4414",91031,2014,0,0,0,0,9
"4415",91040,2014,124,0,124,3.33,3722
"4416",91041,2014,0,0,0,0,43
"4417",91042,2014,194,41,153,4.82,4028
"4418",91043,2014,0,0,0,0,22
"4419",91046,2014,0,0,0,0,74
"4420",91066,2014,0,0,0,0,52
"4421",91077,2014,0,0,0,0,11
"4422",91101,2014,4126,646,3480,16.96,24329
"4423",91102,2014,0,0,0,0,4
"4424",91103,2014,2253,1268,985,24.68,9130
"4425",91104,2014,228,44,184,4.65,4901
"4426",91105,2014,2695,1027,1668,16.14,16702
"4427",91106,2014,657,41,616,7.33,8960
"4428",91107,2014,1510,196,1314,8.45,17865
"4429",91108,2014,242,0,242,7.16,3380
"4430",91109,2014,0,0,0,0,13308
"4431",91114,2014,0,0,0,0,1
"4432",91115,2014,0,0,0,NA,0
"4433",91116,2014,0,0,0,0,14
"4434",91117,2014,0,0,0,0,4
"4435",91118,2014,0,0,0,0,13
"4436",91125,2014,0,0,0,0,56
"4437",91201,2014,813,336,477,5.88,13818
"4438",91202,2014,414,25,389,7.26,5705
"4439",91203,2014,3748,599,3149,18.31,20468
"4440",91204,2014,688,295,393,4.28,16083
"4441",91205,2014,680,137,543,5.86,11605
"4442",91206,2014,529,127,402,4.24,12465
"4443",91207,2014,139,12,127,9.83,1414
"4444",91208,2014,256,17,239,6.36,4025
"4445",91209,2014,0,0,0,0,132
"4446",91210,2014,153,0,153,2.79,5477
"4447",91214,2014,294,10,284,6.5,4523
"4448",91221,2014,0,0,0,0,161
"4449",91222,2014,0,0,0,0,8
"4450",91224,2014,0,0,0,0,4
"4451",91225,2014,0,0,0,0,1
"4452",91226,2014,0,0,0,0,2
"4453",91301,2014,2777,509,2268,20.53,13529
"4454",91302,2014,3565,954,2611,20.77,17167
"4455",91303,2014,708,204,504,5.42,13074
"4456",91304,2014,475,197,278,3.85,12352
"4457",91305,2014,0,0,0,0,211
"4458",91306,2014,157,74,83,3.24,4852
"4459",91307,2014,348,122,226,4.87,7144
"4460",91308,2014,0,0,0,0,30
"4461",91309,2014,0,0,0,0,7
"4462",91310,2014,0,0,0,0,199
"4463",91311,2014,2734,763,1971,7.71,35448
"4464",91313,2014,0,0,0,0,317
"4465",91316,2014,985,219,766,11.28,8733
"4466",91321,2014,454,239,215,5.93,7656
"4467",91322,2014,0,0,0,0,302
"4468",91324,2014,602,0,602,3.2,18796
"4469",91325,2014,224,62,162,2.26,9931
"4470",91326,2014,215,35,180,5.43,3961
"4471",91327,2014,0,0,0,0,6
"4472",91328,2014,13,0,13,0.7,1865
"4473",91330,2014,0,0,0,0,6609
"4474",91331,2014,193,0,193,1.42,13622
"4475",91334,2014,0,0,0,0,19
"4476",91335,2014,345,125,220,2.94,11728
"4477",91337,2014,0,0,0,0,17
"4478",91340,2014,599,84,515,4.37,13692
"4479",91341,2014,0,0,0,0,260
"4480",91342,2014,291,24,267,1.4,20726
"4481",91343,2014,243,19,224,2.43,9984
"4482",91344,2014,339,26,313,3.64,9317
"4483",91345,2014,327,0,327,6.57,4980
"4484",91346,2014,0,0,0,0,2050
"4485",91350,2014,421,98,323,4.7,8963
"4486",91351,2014,486,125,361,6.17,7877
"4487",91352,2014,572,150,422,2.97,19232
"4488",91353,2014,0,0,0,0,188
"4489",91354,2014,135,10,125,7.9,1709
"4490",91355,2014,3367,805,2562,6.74,49942
"4491",91356,2014,1049,189,860,8.33,12600
"4492",91357,2014,0,0,0,0,360
"4493",91361,2014,2942,229,2713,18.72,15718
"4494",91362,2014,2066,248,1818,10.08,20498
"4495",91364,2014,2001,328,1673,11.03,18144
"4496",91365,2014,0,0,0,0,233
"4497",91367,2014,5313,1258,4055,14.91,35645
"4498",91372,2014,0,0,0,0,7
"4499",91376,2014,4,0,4,26.67,15
"4500",91380,2014,0,0,0,0,1301
"4501",91381,2014,229,44,185,5.18,4417
"4502",91383,2014,0,0,0,0,1173
"4503",91384,2014,65,4,61,3.24,2004
"4504",91385,2014,0,0,0,0,13
"4505",91386,2014,0,0,0,0,25
"4506",91387,2014,104,19,85,4.44,2340
"4507",91390,2014,83,16,67,6.95,1194
"4508",91392,2014,0,0,0,0,1606
"4509",91393,2014,0,0,0,0,72
"4510",91394,2014,0,0,0,0,12
"4511",91395,2014,0,0,0,0,3
"4512",91396,2014,0,0,0,0,7
"4513",91401,2014,340,100,240,3.62,9396
"4514",91402,2014,230,104,126,1.73,13304
"4515",91403,2014,3204,913,2291,20.05,15980
"4516",91404,2014,0,0,0,0,14
"4517",91405,2014,955,823,132,6.93,13774
"4518",91406,2014,1977,630,1347,8.03,24630
"4519",91407,2014,0,0,0,0,44
"4520",91408,2014,0,0,0,0,91
"4521",91409,2014,0,0,0,0,848
"4522",91410,2014,0,0,0,0,16
"4523",91411,2014,951,0,951,9.28,10246
"4524",91412,2014,0,0,0,0,113
"4525",91413,2014,0,0,0,0,152
"4526",91416,2014,0,0,0,0,23
"4527",91423,2014,1390,207,1183,12.09,11493
"4528",91426,2014,0,0,0,0,13
"4529",91436,2014,4220,583,3637,25.48,16565
"4530",91501,2014,102,38,64,4.29,2379
"4531",91502,2014,17034,15048,1986,44.18,38557
"4532",91503,2014,0,0,0,0,406
"4533",91504,2014,43892,38853,5039,74.44,58959
"4534",91505,2014,11598,6412,5186,39.4,29435
"4535",91506,2014,732,304,428,7.89,9275
"4536",91507,2014,0,0,0,0,64
"4537",91508,2014,0,0,0,0,2
"4538",91510,2014,352,352,0,42.87,821
"4539",91521,2014,6356,6116,240,73.66,8629
"4540",91522,2014,0,0,0,0,3190
"4541",91523,2014,0,0,0,0,770
"4542",91601,2014,1472,973,499,14.52,10140
"4543",91602,2014,752,315,437,14.68,5124
"4544",91603,2014,0,0,0,0,181
"4545",91604,2014,1385,466,919,12.38,11184
"4546",91605,2014,480,149,331,2.87,16733
"4547",91606,2014,470,125,345,4.64,10130
"4548",91607,2014,663,424,239,12.52,5295
"4549",91608,2014,12983,12803,180,79.92,16245
"4550",91609,2014,0,0,0,0,12
"4551",91610,2014,0,0,0,0,54
"4552",91614,2014,0,0,0,0,27
"4553",91615,2014,0,0,0,0,150
"4554",91617,2014,0,0,0,NA,0
"4555",91702,2014,504,133,371,3.05,16506
"4556",91706,2014,1198,571,627,3.53,33937
"4557",91709,2014,681,13,668,5.28,12893
"4558",91710,2014,1259,182,1077,3.16,39838
"4559",91711,2014,936,31,905,6.67,14030
"4560",91714,2014,0,0,0,0,73
"4561",91715,2014,0,0,0,0,1672
"4562",91716,2014,0,0,0,0,1143
"4563",91722,2014,192,0,192,2.41,7956
"4564",91723,2014,347,104,243,4.85,7152
"4565",91724,2014,427,20,407,6.39,6679
"4566",91731,2014,763,296,467,4.24,18007
"4567",91732,2014,157,0,157,2.4,6529
"4568",91733,2014,531,47,484,2.64,20144
"4569",91734,2014,0,0,0,0,1001
"4570",91740,2014,1180,99,1081,10.41,11339
"4571",91741,2014,184,6,178,3.83,4804
"4572",91744,2014,315,91,224,2.46,12822
"4573",91745,2014,959,265,694,6.05,15855
"4574",91746,2014,498,190,308,2.91,17121
"4575",91747,2014,0,0,0,0,515
"4576",91748,2014,1297,251,1046,4.45,29154
"4577",91749,2014,0,0,0,0,809
"4578",91750,2014,499,53,446,4.45,11214
"4579",91754,2014,1889,298,1591,8.88,21276
"4580",91755,2014,279,10,269,6.2,4498
"4581",91759,2014,0,0,0,0,75
"4582",91765,2014,1088,45,1043,7.85,13855
"4583",91766,2014,208,0,208,1.33,15582
"4584",91767,2014,165,0,165,1.3,12687
"4585",91768,2014,398,0,398,2.22,17961
"4586",91769,2014,0,0,0,0,2111
"4587",91770,2014,471,85,386,2.76,17043
"4588",91773,2014,2587,1709,878,13.39,19317
"4589",91775,2014,153,13,140,4.9,3121
"4590",91776,2014,591,59,532,4.93,11980
"4591",91778,2014,0,0,0,0,956
"4592",91780,2014,278,74,204,4.46,6233
"4593",91788,2014,0,0,0,0,245
"4594",91789,2014,1020,60,960,4.8,21243
"4595",91790,2014,770,350,420,4.96,15530
"4596",91791,2014,584,307,277,6.91,8456
"4597",91792,2014,118,0,118,3.16,3731
"4598",91793,2014,0,0,0,0,70
"4599",91801,2014,796,184,612,4.95,16072
"4600",91802,2014,0,0,0,0,422
"4601",91803,2014,1037,28,1009,11.21,9251
"4602",92397,2014,9,0,9,1.75,513
"4603",92821,2014,3075,251,2824,7.99,38492
"4604",92823,2014,40,0,40,1.08,3693
"4605",93243,2014,0,0,0,0,1979
"4606",93510,2014,18,0,18,1.29,1392
"4607",93523,2014,455,0,455,52.3,870
"4608",93532,2014,0,0,0,0,2081
"4609",93534,2014,1087,84,1003,4.68,23220
"4610",93535,2014,235,95,140,2.7,8701
"4611",93536,2014,276,119,157,2.51,10976
"4612",93539,2014,0,0,0,0,53
"4613",93543,2014,0,0,0,0,799
"4614",93544,2014,0,0,0,0,131
"4615",93550,2014,735,255,480,4.45,16514
"4616",93551,2014,609,276,333,4.93,12358
"4617",93552,2014,14,7,7,0.54,2608
"4618",93553,2014,0,0,0,0,423
"4619",93560,2014,72,0,72,4.72,1525
"4620",93563,2014,0,0,0,0,39
"4621",93584,2014,0,0,0,0,33
"4622",93586,2014,0,0,0,0,8
"4623",93590,2014,0,0,0,0,210
"4624",93591,2014,0,0,0,0,430
"4625",90001,2015,61,0,61,0.67,9046
"4626",90002,2015,0,0,0,0,3070
"4627",90003,2015,29,0,29,0.4,7176
"4628",90004,2015,932,243,689,8.62,10806
"4629",90005,2015,698,294,404,10.65,6552
"4630",90006,2015,326,63,263,3.5,9309
"4631",90007,2015,313,34,279,2.17,14420
"4632",90008,2015,30,0,30,0.48,6296
"4633",90009,2015,0,0,0,0,4371
"4634",90010,2015,5233,666,4567,16.51,31702
"4635",90011,2015,137,0,137,1.19,11476
"4636",90012,2015,3505,2735,770,2.3,152500
"4637",90013,2015,1647,174,1473,9.57,17214
"4638",90014,2015,1176,0,1176,8.89,13226
"4639",90015,2015,1863,594,1269,4.8,38842
"4640",90016,2015,1069,662,407,10.77,9928
"4641",90017,2015,15689,1874,13815,24.75,63393
"4642",90018,2015,135,0,135,2.47,5474
"4643",90019,2015,345,38,307,4.11,8395
"4644",90020,2015,152,50,102,1.08,14118
"4645",90021,2015,791,0,791,2.77,28572
"4646",90022,2015,605,271,334,3.17,19075
"4647",90023,2015,724,89,635,3.64,19915
"4648",90024,2015,4000,727,3273,8.37,47793
"4649",90025,2015,9012,2732,6280,26.51,33998
"4650",90026,2015,607,146,461,6.62,9172
"4651",90027,2015,1063,481,582,4.2,25319
"4652",90028,2015,7276,4337,2939,24.18,30088
"4653",90029,2015,110,21,89,1.52,7250
"4654",90030,2015,0,0,0,0,229
"4655",90031,2015,292,0,292,2.69,10835
"4656",90032,2015,602,9,593,5.78,10410
"4657",90033,2015,226,0,226,1.09,20670
"4658",90034,2015,1169,425,744,9.92,11789
"4659",90035,2015,3196,2758,438,27.26,11724
"4660",90036,2015,5845,3078,2767,20.5,28511
"4661",90037,2015,80,18,62,0.94,8470
"4662",90038,2015,5153,4086,1067,39.19,13150
"4663",90039,2015,598,89,509,5.97,10021
"4664",90040,2015,2330,0,2330,5.33,43698
"4665",90041,2015,459,145,314,5.47,8394
"4666",90042,2015,152,52,100,2.88,5269
"4667",90043,2015,41,18,23,0.66,6177
"4668",90044,2015,0,0,0,0,6857
"4669",90045,2015,4454,2048,2406,6.39,69681
"4670",90046,2015,1929,780,1149,10.89,17719
"4671",90047,2015,77,13,64,1.35,5693
"4672",90048,2015,3324,611,2713,8.74,38053
"4673",90049,2015,4239,2896,1343,24.89,17030
"4674",90050,2015,0,0,0,NA,0
"4675",90051,2015,0,0,0,0,78
"4676",90052,2015,0,0,0,0,2870
"4677",90053,2015,0,0,0,NA,0
"4678",90054,2015,0,0,0,0,11
"4679",90055,2015,0,0,0,0,5
"4680",90056,2015,398,155,243,16.05,2480
"4681",90057,2015,471,74,397,4.28,11013
"4682",90058,2015,26,26,0,0.06,40331
"4683",90059,2015,0,0,0,0,4358
"4684",90060,2015,0,0,0,0,42
"4685",90061,2015,227,31,196,3.19,7117
"4686",90062,2015,3,0,3,0.1,2895
"4687",90063,2015,71,0,71,1.21,5860
"4688",90064,2015,11316,5364,5952,39.8,28431
"4689",90065,2015,718,454,264,7.46,9629
"4690",90066,2015,4512,1218,3294,31.54,14306
"4691",90067,2015,10878,1918,8960,38.14,28524
"4692",90068,2015,861,441,420,18.69,4607
"4693",90069,2015,3146,899,2247,15.66,20086
"4694",90070,2015,0,0,0,NA,0
"4695",90071,2015,10764,0,10764,34.29,31389
"4696",90072,2015,0,0,0,NA,0
"4697",90073,2015,0,0,0,0,4791
"4698",90075,2015,0,0,0,NA,0
"4699",90076,2015,0,0,0,0,32
"4700",90077,2015,124,33,91,4.99,2485
"4701",90078,2015,0,0,0,0,25
"4702",90079,2015,102,33,69,9.07,1125
"4703",90081,2015,0,0,0,NA,0
"4704",90082,2015,0,0,0,NA,0
"4705",90086,2015,0,0,0,0,1341
"4706",90087,2015,0,0,0,0,7
"4707",90089,2015,0,0,0,0,18539
"4708",90091,2015,0,0,0,NA,0
"4709",90093,2015,0,0,0,NA,0
"4710",90094,2015,1304,0,1304,42.19,3091
"4711",90095,2015,164,0,164,1.63,10074
"4712",90201,2015,346,101,245,1.97,17585
"4713",90202,2015,0,0,0,0,57
"4714",90209,2015,7,7,0,50,14
"4715",90210,2015,3316,1688,1628,13.31,24915
"4716",90211,2015,2213,501,1712,17.47,12668
"4717",90212,2015,2624,439,2185,15.38,17065
"4718",90213,2015,0,0,0,0,180
"4719",90220,2015,709,0,709,2,35367
"4720",90221,2015,209,0,209,1.63,12805
"4721",90222,2015,0,0,0,0,3281
"4722",90223,2015,0,0,0,NA,0
"4723",90224,2015,0,0,0,0,161
"4724",90230,2015,4718,3181,1537,15.13,31185
"4725",90231,2015,0,0,0,0,8326
"4726",90232,2015,6348,1626,4722,33.4,19004
"4727",90233,2015,0,0,0,NA,0
"4728",90239,2015,0,0,0,0,104
"4729",90240,2015,302,30,272,6.2,4871
"4730",90241,2015,405,153,252,2.11,19227
"4731",90242,2015,265,48,217,2.21,12000
"4732",90245,2015,20990,5276,15714,33.25,63129
"4733",90247,2015,328,192,136,2.25,14583
"4734",90248,2015,888,0,888,2.55,34869
"4735",90249,2015,104,0,104,0.97,10746
"4736",90250,2015,660,182,478,2.8,23590
"4737",90251,2015,0,0,0,0,85
"4738",90254,2015,836,328,508,11.6,7204
"4739",90255,2015,337,127,210,2.26,14914
"4740",90260,2015,290,19,271,4.76,6090
"4741",90261,2015,12,0,12,0.85,1414
"4742",90262,2015,148,48,100,1.28,11521
"4743",90263,2015,0,0,0,0,1740
"4744",90264,2015,0,0,0,0,18
"4745",90265,2015,1146,185,961,14.55,7875
"4746",90266,2015,2206,514,1692,13.03,16936
"4747",90267,2015,0,0,0,0,52
"4748",90270,2015,27,0,27,0.56,4838
"4749",90272,2015,1070,586,484,20.98,5100
"4750",90274,2015,834,199,635,11.38,7330
"4751",90275,2015,417,11,406,7.7,5418
"4752",90277,2015,940,131,809,7.99,11759
"4753",90278,2015,1348,183,1165,9.29,14510
"4754",90280,2015,692,0,692,2.48,27931
"4755",90290,2015,84,38,46,10.84,775
"4756",90291,2015,2166,778,1388,19.33,11207
"4757",90292,2015,2640,360,2280,18.51,14265
"4758",90293,2015,209,29,180,15.5,1348
"4759",90294,2015,0,0,0,NA,0
"4760",90295,2015,0,0,0,0,6
"4761",90301,2015,373,105,268,2.5,14900
"4762",90302,2015,83,0,83,1.71,4854
"4763",90303,2015,135,0,135,2.42,5570
"4764",90304,2015,55,0,55,1.56,3520
"4765",90305,2015,0,0,0,0,1181
"4766",90306,2015,0,0,0,0,34
"4767",90307,2015,0,0,0,0,8
"4768",90308,2015,0,0,0,0,43
"4769",90309,2015,0,0,0,NA,0
"4770",90310,2015,0,0,0,0,132
"4771",90311,2015,0,0,0,NA,0
"4772",90312,2015,0,0,0,0,39
"4773",90401,2015,6583,3019,3564,22.22,29621
"4774",90402,2015,272,158,114,13.41,2029
"4775",90403,2015,1170,171,999,12.78,9152
"4776",90404,2015,11064,6287,4777,37.11,29816
"4777",90405,2015,3909,958,2951,21.79,17937
"4778",90406,2015,0,0,0,0,352
"4779",90407,2015,0,0,0,NA,0
"4780",90408,2015,0,0,0,NA,0
"4781",90409,2015,0,0,0,0,6
"4782",90410,2015,0,0,0,0,50
"4783",90501,2015,2681,402,2279,10.88,24647
"4784",90502,2015,1526,0,1526,8.98,17000
"4785",90503,2015,2503,713,1790,7.48,33474
"4786",90504,2015,588,195,393,6.5,9050
"4787",90505,2015,2402,159,2243,8.22,29220
"4788",90506,2015,0,0,0,NA,0
"4789",90507,2015,0,0,0,NA,0
"4790",90509,2015,85,0,85,1.63,5214
"4791",90510,2015,0,0,0,0,11
"4792",90601,2015,161,13,148,1.32,12239
"4793",90602,2015,262,0,262,2.95,8877
"4794",90603,2015,99,0,99,2.22,4469
"4795",90604,2015,30,0,30,1.08,2766
"4796",90605,2015,216,9,207,2.53,8526
"4797",90606,2015,141,0,141,2.3,6135
"4798",90607,2015,0,0,0,0,239
"4799",90608,2015,0,0,0,0,1999
"4800",90609,2015,0,0,0,NA,0
"4801",90610,2015,0,0,0,NA,0
"4802",90623,2015,413,0,413,6.26,6601
"4803",90630,2015,2549,796,1753,10.86,23475
"4804",90631,2015,479,118,361,2.96,16207
"4805",90637,2015,0,0,0,0,127
"4806",90638,2015,583,74,509,3.78,15405
"4807",90639,2015,0,0,0,0,1478
"4808",90640,2015,547,85,462,2.37,23079
"4809",90650,2015,586,146,440,2.64,22186
"4810",90651,2015,0,0,0,0,114
"4811",90652,2015,0,0,0,NA,0
"4812",90660,2015,325,77,248,2.01,16130
"4813",90662,2015,0,0,0,NA,0
"4814",90670,2015,1517,269,1248,2.77,54697
"4815",90701,2015,149,0,149,1.54,9667
"4816",90702,2015,0,0,0,0,449
"4817",90703,2015,2280,1058,1222,7.1,32092
"4818",90704,2015,0,0,0,0,2593
"4819",90706,2015,236,0,236,1.22,19357
"4820",90707,2015,0,0,0,0,79
"4821",90710,2015,135,20,115,1.88,7179
"4822",90711,2015,0,0,0,0,48
"4823",90712,2015,481,221,260,4.05,11877
"4824",90713,2015,47,0,47,1.23,3828
"4825",90714,2015,0,0,0,0,1119
"4826",90715,2015,38,0,38,2.78,1366
"4827",90716,2015,7,0,7,0.17,4040
"4828",90717,2015,157,10,147,4.2,3742
"4829",90723,2015,533,115,418,2.91,18295
"4830",90731,2015,605,98,507,4.81,12568
"4831",90732,2015,87,7,80,2.75,3166
"4832",90733,2015,0,0,0,0,80
"4833",90734,2015,0,0,0,NA,0
"4834",90744,2015,235,101,134,1.99,11784
"4835",90745,2015,289,24,265,2.01,14397
"4836",90746,2015,998,151,847,6.73,14820
"4837",90747,2015,0,0,0,0,2621
"4838",90748,2015,0,0,0,0,449
"4839",90749,2015,33,0,33,2.42,1362
"4840",90755,2015,555,55,500,4.77,11645
"4841",90801,2015,39,0,39,0.51,7688
"4842",90802,2015,3074,133,2941,11.22,27408
"4843",90803,2015,861,150,711,8.82,9760
"4844",90804,2015,561,0,561,6.23,9000
"4845",90805,2015,160,0,160,1.12,14285
"4846",90806,2015,1239,44,1195,8.75,14168
"4847",90807,2015,1266,0,1266,9.38,13502
"4848",90808,2015,605,311,294,5.47,11066
"4849",90809,2015,0,0,0,0,187
"4850",90810,2015,764,218,546,5.02,15217
"4851",90813,2015,278,0,278,2.18,12745
"4852",90814,2015,60,0,60,2.91,2062
"4853",90815,2015,937,280,657,7.05,13299
"4854",90822,2015,0,0,0,0,3216
"4855",90831,2015,213,0,213,16.89,1261
"4856",90840,2015,0,0,0,0,5670
"4857",90846,2015,0,0,0,0,2714
"4858",90853,2015,0,0,0,NA,0
"4859",91001,2015,299,49,250,7.55,3961
"4860",91003,2015,0,0,0,0,62
"4861",91006,2015,1124,50,1074,8.5,13229
"4862",91007,2015,623,111,512,4.65,13395
"4863",91008,2015,0,0,0,0,63
"4864",91009,2015,0,0,0,0,351
"4865",91010,2015,116,6,110,0.98,11844
"4866",91011,2015,327,106,221,5.4,6060
"4867",91012,2015,0,0,0,0,4
"4868",91016,2015,2140,218,1922,12.54,17062
"4869",91017,2015,0,0,0,0,267
"4870",91020,2015,215,0,215,7.66,2807
"4871",91021,2015,0,0,0,0,51
"4872",91024,2015,96,4,92,4.04,2374
"4873",91025,2015,0,0,0,0,17
"4874",91030,2015,749,112,637,11.57,6475
"4875",91031,2015,0,0,0,0,10
"4876",91040,2015,145,0,145,4.23,3425
"4877",91041,2015,0,0,0,0,39
"4878",91042,2015,220,58,162,5.42,4059
"4879",91043,2015,0,0,0,0,25
"4880",91046,2015,0,0,0,0,74
"4881",91066,2015,0,0,0,0,57
"4882",91077,2015,0,0,0,0,7
"4883",91101,2015,4584,775,3809,18.19,25201
"4884",91102,2015,0,0,0,0,120
"4885",91103,2015,2203,1345,858,23.39,9420
"4886",91104,2015,267,28,239,5.34,5000
"4887",91105,2015,2460,1012,1448,14.35,17148
"4888",91106,2015,657,45,612,7.65,8590
"4889",91107,2015,1531,132,1399,8.23,18607
"4890",91108,2015,257,0,257,7.39,3478
"4891",91109,2015,0,0,0,0,13829
"4892",91114,2015,0,0,0,0,13
"4893",91115,2015,0,0,0,NA,0
"4894",91116,2015,0,0,0,NA,0
"4895",91117,2015,0,0,0,NA,0
"4896",91118,2015,0,0,0,NA,0
"4897",91125,2015,0,0,0,0,96
"4898",91126,2015,0,0,0,NA,0
"4899",91201,2015,888,330,558,5.94,14962
"4900",91202,2015,426,13,413,7.45,5715
"4901",91203,2015,4058,655,3403,19.14,21203
"4902",91204,2015,541,87,454,3.35,16135
"4903",91205,2015,721,201,520,5.67,12718
"4904",91206,2015,496,100,396,3.92,12668
"4905",91207,2015,85,11,74,6.47,1313
"4906",91208,2015,253,21,232,5.67,4462
"4907",91209,2015,0,0,0,0,141
"4908",91210,2015,265,126,139,4.82,5499
"4909",91214,2015,303,18,285,6.2,4890
"4910",91221,2015,0,0,0,0,176
"4911",91222,2015,0,0,0,NA,0
"4912",91224,2015,0,0,0,NA,0
"4913",91225,2015,0,0,0,NA,0
"4914",91226,2015,0,0,0,0,4
"4915",91301,2015,4041,748,3293,27.18,14866
"4916",91302,2015,3179,653,2526,18.74,16966
"4917",91303,2015,606,183,423,4.97,12184
"4918",91304,2015,633,275,358,4.71,13449
"4919",91305,2015,0,0,0,0,191
"4920",91306,2015,237,125,112,4.53,5228
"4921",91307,2015,396,126,270,5.27,7518
"4922",91308,2015,0,0,0,0,18
"4923",91309,2015,0,0,0,0,6
"4924",91310,2015,0,0,0,0,178
"4925",91311,2015,2765,846,1919,7.69,35937
"4926",91313,2015,0,0,0,0,322
"4927",91316,2015,979,313,666,10.58,9254
"4928",91321,2015,429,211,218,5.27,8141
"4929",91322,2015,0,0,0,0,319
"4930",91324,2015,602,0,602,3.16,19038
"4931",91325,2015,204,46,158,2.04,9998
"4932",91326,2015,208,39,169,5.32,3911
"4933",91327,2015,0,0,0,0,11
"4934",91328,2015,15,0,15,0.77,1938
"4935",91330,2015,0,0,0,0,6874
"4936",91331,2015,233,0,233,1.71,13651
"4937",91334,2015,0,0,0,0,20
"4938",91335,2015,354,133,221,2.96,11965
"4939",91337,2015,0,0,0,0,14
"4940",91340,2015,620,188,432,4.47,13855
"4941",91341,2015,0,0,0,0,268
"4942",91342,2015,278,20,258,1.27,21817
"4943",91343,2015,217,28,189,2.27,9554
"4944",91344,2015,360,30,330,3.57,10075
"4945",91345,2015,279,0,279,5.04,5541
"4946",91346,2015,0,0,0,0,2206
"4947",91350,2015,383,63,320,4.26,8990
"4948",91351,2015,491,138,353,6.63,7409
"4949",91352,2015,643,200,443,3.19,20152
"4950",91353,2015,0,0,0,0,159
"4951",91354,2015,174,19,155,9.2,1891
"4952",91355,2015,3572,844,2728,6.87,52030
"4953",91356,2015,1189,253,936,9.11,13058
"4954",91357,2015,0,0,0,0,250
"4955",91361,2015,3178,329,2849,19.51,16288
"4956",91362,2015,2274,315,1959,10.69,21272
"4957",91364,2015,1783,241,1542,9.55,18668
"4958",91365,2015,0,0,0,0,264
"4959",91367,2015,5654,1166,4488,14.78,38247
"4960",91372,2015,0,0,0,0,8
"4961",91376,2015,2,0,2,5.71,35
"4962",91380,2015,0,0,0,0,1404
"4963",91381,2015,240,25,215,5.2,4613
"4964",91382,2015,0,0,0,NA,0
"4965",91383,2015,0,0,0,0,1139
"4966",91384,2015,55,3,52,2.57,2141
"4967",91385,2015,0,0,0,NA,0
"4968",91386,2015,0,0,0,0,31
"4969",91387,2015,145,27,118,6.25,2320
"4970",91390,2015,129,21,108,9.68,1332
"4971",91392,2015,0,0,0,0,1552
"4972",91393,2015,0,0,0,0,80
"4973",91394,2015,0,0,0,0,12
"4974",91395,2015,0,0,0,0,3
"4975",91401,2015,347,106,241,3.56,9756
"4976",91402,2015,239,87,152,1.72,13873
"4977",91403,2015,3038,784,2254,19.74,15393
"4978",91404,2015,0,0,0,0,88
"4979",91405,2015,1004,881,123,6.97,14403
"4980",91406,2015,2101,592,1509,7.77,27027
"4981",91407,2015,0,0,0,NA,0
"4982",91408,2015,0,0,0,0,160
"4983",91409,2015,0,0,0,0,899
"4984",91410,2015,0,0,0,NA,0
"4985",91411,2015,760,0,760,7.75,9807
"4986",91412,2015,0,0,0,0,137
"4987",91413,2015,0,0,0,0,112
"4988",91416,2015,0,0,0,0,21
"4989",91423,2015,1721,282,1439,14.19,12131
"4990",91426,2015,0,0,0,0,9
"4991",91436,2015,4286,526,3760,25.34,16914
"4992",91501,2015,86,29,57,3.65,2358
"4993",91502,2015,12257,10807,1450,35.85,34187
"4994",91503,2015,0,0,0,0,306
"4995",91504,2015,55699,51467,4232,78.94,70557
"4996",91505,2015,12264,6728,5536,40.27,30456
"4997",91506,2015,933,435,498,9.23,10108
"4998",91507,2015,0,0,0,NA,0
"4999",91510,2015,638,638,0,55.96,1140
"5000",91521,2015,7048,6066,982,76.14,9257
"5001",91522,2015,0,0,0,0,3616
"5002",91523,2015,0,0,0,0,824
"5003",91601,2015,1557,974,583,15.03,10356
"5004",91602,2015,735,309,426,13.78,5334
"5005",91603,2015,0,0,0,0,156
"5006",91604,2015,1444,528,916,11.64,12402
"5007",91605,2015,506,139,367,2.94,17184
"5008",91606,2015,489,153,336,5.55,8814
"5009",91607,2015,613,360,253,11.63,5273
"5010",91608,2015,12962,12838,124,79.47,16311
"5011",91609,2015,0,0,0,0,17
"5012",91610,2015,0,0,0,0,44
"5013",91614,2015,0,0,0,0,24
"5014",91615,2015,0,0,0,0,145
"5015",91702,2015,648,134,514,3.74,17324
"5016",91706,2015,1108,583,525,3.28,33741
"5017",91709,2015,635,0,635,4.56,13937
"5018",91710,2015,1366,196,1170,3.31,41217
"5019",91711,2015,907,31,876,6.28,14450
"5020",91714,2015,0,0,0,NA,0
"5021",91715,2015,0,0,0,0,2047
"5022",91716,2015,0,0,0,0,1137
"5023",91722,2015,173,0,173,2.18,7936
"5024",91723,2015,352,88,264,4.63,7597
"5025",91724,2015,419,29,390,6.03,6952
"5026",91731,2015,722,316,406,4.08,17712
"5027",91732,2015,210,116,94,3.08,6829
"5028",91733,2015,530,57,473,2.64,20077
"5029",91734,2015,0,0,0,0,1066
"5030",91740,2015,1256,100,1156,10.67,11776
"5031",91741,2015,195,4,191,3.92,4974
"5032",91744,2015,355,88,267,2.69,13211
"5033",91745,2015,766,243,523,5.04,15201
"5034",91746,2015,578,167,411,3.11,18586
"5035",91747,2015,0,0,0,0,544
"5036",91748,2015,1286,301,985,4.23,30386
"5037",91749,2015,0,0,0,0,807
"5038",91750,2015,506,61,445,4.38,11541
"5039",91754,2015,1511,283,1228,7.2,20998
"5040",91755,2015,242,6,236,5.28,4586
"5041",91759,2015,0,0,0,0,80
"5042",91765,2015,1092,53,1039,7.33,14891
"5043",91766,2015,206,0,206,1.31,15725
"5044",91767,2015,254,0,254,1.94,13068
"5045",91768,2015,400,0,400,2.11,18979
"5046",91769,2015,0,0,0,0,1694
"5047",91770,2015,466,95,371,2.7,17247
"5048",91773,2015,2502,1576,926,12.71,19683
"5049",91775,2015,134,9,125,4.32,3105
"5050",91776,2015,743,89,654,6.24,11902
"5051",91778,2015,0,0,0,0,981
"5052",91780,2015,230,55,175,3.68,6254
"5053",91788,2015,0,0,0,0,283
"5054",91789,2015,1104,61,1043,5.02,22012
"5055",91790,2015,657,324,333,4.25,15454
"5056",91791,2015,409,141,268,4.72,8657
"5057",91792,2015,136,0,136,3.51,3874
"5058",91793,2015,0,0,0,0,73
"5059",91801,2015,873,171,702,5.37,16258
"5060",91802,2015,0,0,0,0,411
"5061",91803,2015,344,17,327,3.84,8955
"5062",92397,2015,6,0,6,1.13,533
"5063",92821,2015,2488,482,2006,6.42,38738
"5064",92823,2015,92,0,92,2.81,3277
"5065",93243,2015,0,0,0,0,2286
"5066",93510,2015,31,0,31,2.26,1373
"5067",93523,2015,401,0,401,51.61,777
"5068",93532,2015,0,0,0,0,2025
"5069",93534,2015,1131,92,1039,4.72,23979
"5070",93535,2015,274,100,174,2.83,9686
"5071",93536,2015,289,121,168,2.64,10956
"5072",93539,2015,0,0,0,0,53
"5073",93543,2015,0,0,0,0,820
"5074",93544,2015,0,0,0,0,131
"5075",93550,2015,763,230,533,4.58,16654
"5076",93551,2015,657,295,362,5.21,12616
"5077",93552,2015,11,7,4,0.43,2546
"5078",93553,2015,0,0,0,0,440
"5079",93560,2015,58,0,58,3.82,1517
"5080",93563,2015,0,0,0,0,45
"5081",93584,2015,0,0,0,0,43
"5082",93586,2015,0,0,0,0,10
"5083",93590,2015,0,0,0,0,202
"5084",93591,2015,0,0,0,0,460
"5085",90001,2016,71,0,71,0.78,9079
"5086",90002,2016,24,0,24,0.81,2945
"5087",90003,2016,31,0,31,0.46,6721
"5088",90004,2016,956,269,687,8.76,10910
"5089",90005,2016,570,251,319,9,6334
"5090",90006,2016,340,63,277,3.73,9105
"5091",90007,2016,267,0,267,1.78,15016
"5092",90008,2016,26,0,26,0.39,6615
"5093",90009,2016,0,0,0,0,5783
"5094",90010,2016,5182,690,4492,17.15,30220
"5095",90011,2016,160,0,160,1.44,11109
"5096",90012,2016,3610,2799,811,2.32,155269
"5097",90013,2016,1341,208,1133,7.52,17829
"5098",90014,2016,1501,35,1466,10.78,13924
"5099",90015,2016,2008,606,1402,5.24,38349
"5100",90016,2016,1196,725,471,11.71,10216
"5101",90017,2016,16032,1792,14240,25.1,63885
"5102",90018,2016,154,16,138,2.96,5204
"5103",90019,2016,504,49,455,5.85,8613
"5104",90020,2016,114,0,114,0.76,14945
"5105",90021,2016,874,0,874,2.71,32296
"5106",90022,2016,601,236,365,3.19,18814
"5107",90023,2016,496,78,418,2.53,19572
"5108",90024,2016,3956,695,3261,8.31,47602
"5109",90025,2016,8775,3109,5666,24.97,35140
"5110",90026,2016,595,152,443,6.1,9747
"5111",90027,2016,1098,478,620,4.3,25530
"5112",90028,2016,7371,4558,2813,24.07,30618
"5113",90029,2016,122,23,99,1.71,7124
"5114",90030,2016,0,0,0,0,243
"5115",90031,2016,395,86,309,3.56,11103
"5116",90032,2016,550,3,547,5.5,10006
"5117",90033,2016,294,32,262,1.41,20801
"5118",90034,2016,1298,509,789,10.87,11943
"5119",90035,2016,3061,2674,387,26.62,11499
"5120",90036,2016,5497,2823,2674,19.02,28900
"5121",90037,2016,66,13,53,0.71,9265
"5122",90038,2016,4925,3696,1229,36.86,13360
"5123",90039,2016,587,106,481,5.79,10135
"5124",90040,2016,2579,247,2332,5.69,45307
"5125",90041,2016,468,129,339,5.42,8636
"5126",90042,2016,148,49,99,2.91,5088
"5127",90043,2016,51,15,36,0.82,6210
"5128",90044,2016,0,0,0,0,6583
"5129",90045,2016,4257,1924,2333,5.88,72401
"5130",90046,2016,2198,922,1276,12.25,17949
"5131",90047,2016,73,14,59,1.27,5751
"5132",90048,2016,3252,609,2643,9.16,35514
"5133",90049,2016,4843,3192,1651,26.39,18350
"5134",90051,2016,0,0,0,0,75
"5135",90052,2016,0,0,0,0,3162
"5136",90053,2016,0,0,0,NA,0
"5137",90054,2016,0,0,0,0,13
"5138",90055,2016,0,0,0,0,4
"5139",90056,2016,106,106,0,4.07,2607
"5140",90057,2016,509,50,459,4.41,11530
"5141",90058,2016,19,19,0,0.05,38936
"5142",90059,2016,0,0,0,0,4228
"5143",90060,2016,0,0,0,0,46
"5144",90061,2016,229,22,207,3.24,7078
"5145",90062,2016,3,0,3,0.1,2979
"5146",90063,2016,71,0,71,1.2,5936
"5147",90064,2016,10534,5392,5142,37.92,27781
"5148",90065,2016,537,299,238,5.66,9488
"5149",90066,2016,4480,1246,3234,30.95,14475
"5150",90067,2016,10920,1836,9084,39.13,27910
"5151",90068,2016,840,396,444,16.92,4966
"5152",90069,2016,2969,962,2007,14.02,21176
"5153",90070,2016,0,0,0,NA,0
"5154",90071,2016,11973,0,11973,36.19,33083
"5155",90072,2016,0,0,0,NA,0
"5156",90073,2016,0,0,0,0,4692
"5157",90076,2016,0,0,0,0,31
"5158",90077,2016,113,26,87,4.48,2523
"5159",90078,2016,0,0,0,0,30
"5160",90079,2016,104,35,69,10.07,1033
"5161",90081,2016,0,0,0,NA,0
"5162",90082,2016,0,0,0,NA,0
"5163",90086,2016,0,0,0,0,827
"5164",90087,2016,0,0,0,0,4
"5165",90089,2016,0,0,0,0,18507
"5166",90091,2016,0,0,0,NA,0
"5167",90093,2016,0,0,0,NA,0
"5168",90094,2016,1970,478,1492,52.91,3723
"5169",90095,2016,55,0,55,0.53,10432
"5170",90201,2016,351,117,234,2.02,17388
"5171",90202,2016,0,0,0,0,47
"5172",90209,2016,4,4,0,33.33,12
"5173",90210,2016,3353,1818,1535,13.63,24597
"5174",90211,2016,1911,481,1430,15.25,12534
"5175",90212,2016,3335,549,2786,20.55,16227
"5176",90213,2016,0,0,0,0,198
"5177",90220,2016,774,0,774,2.43,31902
"5178",90221,2016,100,0,100,0.68,14702
"5179",90222,2016,0,0,0,0,2939
"5180",90223,2016,0,0,0,NA,0
"5181",90224,2016,0,0,0,0,155
"5182",90230,2016,4933,3402,1531,15.6,31629
"5183",90231,2016,0,0,0,0,8282
"5184",90232,2016,7986,4232,3754,39.66,20137
"5185",90233,2016,0,0,0,NA,0
"5186",90239,2016,0,0,0,0,114
"5187",90240,2016,228,19,209,4.33,5270
"5188",90241,2016,468,164,304,2.65,17649
"5189",90242,2016,390,148,242,2.76,14113
"5190",90245,2016,16029,5276,10753,25.5,62858
"5191",90247,2016,318,167,151,2.42,13141
"5192",90248,2016,1755,0,1755,4.69,37452
"5193",90249,2016,130,0,130,1.14,11387
"5194",90250,2016,602,142,460,2.51,23944
"5195",90251,2016,0,0,0,0,87
"5196",90254,2016,921,384,537,11.94,7715
"5197",90255,2016,303,104,199,2.09,14513
"5198",90260,2016,247,0,247,3.96,6242
"5199",90261,2016,10,0,10,0.72,1381
"5200",90262,2016,139,34,105,1.27,10920
"5201",90263,2016,0,0,0,0,1731
"5202",90264,2016,0,0,0,0,23
"5203",90265,2016,1275,271,1004,15.45,8254
"5204",90266,2016,2244,479,1765,12.89,17409
"5205",90267,2016,2,0,2,4.35,46
"5206",90270,2016,17,0,17,0.37,4568
"5207",90272,2016,455,128,327,10.2,4461
"5208",90274,2016,936,180,756,12.42,7537
"5209",90275,2016,499,8,491,8.77,5688
"5210",90277,2016,942,116,826,8.13,11588
"5211",90278,2016,1281,217,1064,9.48,13515
"5212",90280,2016,802,0,802,3.26,24607
"5213",90290,2016,80,27,53,9.78,818
"5214",90291,2016,5229,3653,1576,36.09,14488
"5215",90292,2016,2651,409,2242,17.99,14740
"5216",90293,2016,245,20,225,18.19,1347
"5217",90294,2016,0,0,0,NA,0
"5218",90295,2016,0,0,0,0,9
"5219",90296,2016,0,0,0,NA,0
"5220",90301,2016,404,126,278,2.69,15037
"5221",90302,2016,130,0,130,2.79,4665
"5222",90303,2016,62,0,62,1.09,5683
"5223",90304,2016,53,0,53,1.43,3700
"5224",90305,2016,7,0,7,0.68,1037
"5225",90306,2016,0,0,0,0,28
"5226",90307,2016,0,0,0,0,9
"5227",90308,2016,0,0,0,0,40
"5228",90309,2016,0,0,0,NA,0
"5229",90310,2016,0,0,0,0,134
"5230",90311,2016,0,0,0,NA,0
"5231",90312,2016,0,0,0,0,48
"5232",90401,2016,6785,3107,3678,22.95,29567
"5233",90402,2016,240,107,133,12.09,1985
"5234",90403,2016,1035,142,893,11.49,9008
"5235",90404,2016,13796,9094,4702,44.89,30730
"5236",90405,2016,3771,1124,2647,20.78,18150
"5237",90406,2016,0,0,0,0,372
"5238",90407,2016,0,0,0,0,17
"5239",90408,2016,0,0,0,0,35
"5240",90409,2016,0,0,0,0,6
"5241",90410,2016,0,0,0,0,44
"5242",90501,2016,2608,318,2290,9.98,26143
"5243",90502,2016,1560,0,1560,10.4,15007
"5244",90503,2016,2634,705,1929,7.81,33739
"5245",90504,2016,501,146,355,5.48,9148
"5246",90505,2016,2355,118,2237,7.8,30178
"5247",90506,2016,0,0,0,NA,0
"5248",90507,2016,0,0,0,NA,0
"5249",90509,2016,0,0,0,0,4413
"5250",90510,2016,0,0,0,0,8
"5251",90601,2016,168,10,158,1.24,13500
"5252",90602,2016,633,0,633,6.65,9522
"5253",90603,2016,105,0,105,2.3,4556
"5254",90604,2016,24,0,24,0.9,2670
"5255",90605,2016,111,0,111,1.3,8521
"5256",90606,2016,96,0,96,1.63,5891
"5257",90607,2016,0,0,0,0,281
"5258",90608,2016,0,0,0,0,2024
"5259",90609,2016,0,0,0,NA,0
"5260",90610,2016,0,0,0,0,4
"5261",90623,2016,417,0,417,5.33,7820
"5262",90630,2016,3406,852,2554,14.33,23765
"5263",90631,2016,402,67,335,2.58,15611
"5264",90637,2016,0,0,0,0,95
"5265",90638,2016,606,86,520,3.79,16000
"5266",90639,2016,0,0,0,0,1696
"5267",90640,2016,562,77,485,2.48,22630
"5268",90650,2016,526,131,395,2.49,21124
"5269",90651,2016,0,0,0,0,94
"5270",90652,2016,0,0,0,NA,0
"5271",90660,2016,340,93,247,2.02,16819
"5272",90662,2016,0,0,0,NA,0
"5273",90670,2016,1599,232,1367,2.95,54138
"5274",90701,2016,146,0,146,1.48,9898
"5275",90702,2016,0,0,0,0,439
"5276",90703,2016,2633,1210,1423,7.55,34855
"5277",90704,2016,0,0,0,0,2507
"5278",90706,2016,251,0,251,1.3,19350
"5279",90707,2016,0,0,0,0,76
"5280",90710,2016,231,21,210,2.99,7735
"5281",90711,2016,0,0,0,0,43
"5282",90712,2016,407,173,234,3.5,11615
"5283",90713,2016,47,0,47,1.19,3940
"5284",90714,2016,0,0,0,0,748
"5285",90715,2016,58,0,58,4.67,1242
"5286",90716,2016,5,0,5,0.12,4049
"5287",90717,2016,137,11,126,3.75,3655
"5288",90723,2016,444,83,361,2.4,18492
"5289",90731,2016,493,100,393,4.28,11530
"5290",90732,2016,103,8,95,3.21,3204
"5291",90733,2016,0,0,0,0,52
"5292",90734,2016,0,0,0,NA,0
"5293",90744,2016,222,75,147,1.82,12184
"5294",90745,2016,324,25,299,2.17,14909
"5295",90746,2016,950,118,832,6.29,15110
"5296",90747,2016,0,0,0,0,2567
"5297",90748,2016,0,0,0,0,503
"5298",90749,2016,34,0,34,2.48,1373
"5299",90755,2016,642,63,579,5.42,11844
"5300",90801,2016,40,0,40,0.6,6628
"5301",90802,2016,2864,144,2720,10.84,26420
"5302",90803,2016,644,112,532,6.76,9529
"5303",90804,2016,534,0,534,5.9,9058
"5304",90805,2016,144,0,144,1,14380
"5305",90806,2016,1215,29,1186,8.36,14530
"5306",90807,2016,1020,0,1020,8.04,12693
"5307",90808,2016,773,232,541,6.52,11859
"5308",90809,2016,0,0,0,0,181
"5309",90810,2016,821,285,536,5.03,16316
"5310",90813,2016,331,0,331,2.67,12411
"5311",90814,2016,74,0,74,3.56,2079
"5312",90815,2016,898,217,681,6.77,13261
"5313",90822,2016,0,0,0,0,3288
"5314",90831,2016,188,0,188,15.31,1228
"5315",90840,2016,0,0,0,0,5905
"5316",90846,2016,0,0,0,0,1897
"5317",90853,2016,0,0,0,NA,0
"5318",91001,2016,407,50,357,9.7,4198
"5319",91003,2016,0,0,0,0,66
"5320",91006,2016,1132,67,1065,8.35,13554
"5321",91007,2016,703,114,589,5.14,13675
"5322",91008,2016,0,0,0,0,87
"5323",91009,2016,0,0,0,NA,0
"5324",91010,2016,143,7,136,1.14,12552
"5325",91011,2016,305,95,210,5.4,5647
"5326",91012,2016,0,0,0,0,5
"5327",91016,2016,2069,196,1873,11.74,17625
"5328",91017,2016,0,0,0,0,249
"5329",91020,2016,241,0,241,8.92,2703
"5330",91021,2016,0,0,0,0,57
"5331",91024,2016,78,10,68,3.1,2518
"5332",91025,2016,0,0,0,0,21
"5333",91030,2016,770,108,662,11.22,6863
"5334",91031,2016,0,0,0,0,30
"5335",91040,2016,159,0,159,5.23,3041
"5336",91041,2016,0,0,0,0,40
"5337",91042,2016,268,72,196,6.64,4037
"5338",91043,2016,0,0,0,0,32
"5339",91046,2016,0,0,0,0,71
"5340",91066,2016,0,0,0,0,74
"5341",91077,2016,0,0,0,0,8
"5342",91101,2016,4695,1042,3653,18.34,25602
"5343",91102,2016,0,0,0,0,128
"5344",91103,2016,2194,1298,896,22.56,9725
"5345",91104,2016,261,38,223,4.73,5520
"5346",91105,2016,2184,860,1324,12.65,17264
"5347",91106,2016,647,80,567,7.39,8751
"5348",91107,2016,1507,90,1417,7.84,19227
"5349",91108,2016,379,0,379,10.64,3561
"5350",91109,2016,0,0,0,0,12879
"5351",91114,2016,0,0,0,0,4
"5352",91116,2016,0,0,0,NA,0
"5353",91117,2016,0,0,0,NA,0
"5354",91118,2016,0,0,0,NA,0
"5355",91125,2016,0,0,0,0,92
"5356",91126,2016,0,0,0,NA,0
"5357",91201,2016,1216,565,651,8.19,14846
"5358",91202,2016,417,16,401,7.33,5691
"5359",91203,2016,4012,571,3441,18.14,22115
"5360",91204,2016,638,74,564,4.01,15922
"5361",91205,2016,758,214,544,5.89,12878
"5362",91206,2016,429,69,360,3.37,12748
"5363",91207,2016,108,19,89,8.33,1296
"5364",91208,2016,276,14,262,6.1,4526
"5365",91209,2016,0,0,0,0,149
"5366",91210,2016,254,109,145,4.55,5585
"5367",91214,2016,259,8,251,5.13,5044
"5368",91221,2016,0,0,0,0,156
"5369",91222,2016,0,0,0,0,14
"5370",91224,2016,0,0,0,NA,0
"5371",91225,2016,0,0,0,NA,0
"5372",91226,2016,0,0,0,0,4
"5373",91301,2016,2811,713,2098,21.09,13331
"5374",91302,2016,3141,637,2504,18.22,17239
"5375",91303,2016,618,184,434,4.96,12449
"5376",91304,2016,795,330,465,5.74,13857
"5377",91305,2016,0,0,0,0,210
"5378",91306,2016,98,0,98,1.87,5252
"5379",91307,2016,228,80,148,3.11,7337
"5380",91308,2016,0,0,0,0,24
"5381",91309,2016,0,0,0,0,6
"5382",91310,2016,0,0,0,0,183
"5383",91311,2016,2711,890,1821,7.72,35104
"5384",91313,2016,0,0,0,0,371
"5385",91316,2016,847,124,723,8.97,9446
"5386",91321,2016,415,193,222,4.94,8405
"5387",91322,2016,0,0,0,0,327
"5388",91324,2016,746,114,632,4.03,18517
"5389",91325,2016,209,37,172,1.98,10550
"5390",91326,2016,255,46,209,5.94,4295
"5391",91327,2016,0,0,0,0,21
"5392",91328,2016,0,0,0,0,1846
"5393",91330,2016,0,0,0,0,6929
"5394",91331,2016,233,0,233,1.72,13582
"5395",91333,2016,0,0,0,NA,0
"5396",91334,2016,0,0,0,0,16
"5397",91335,2016,313,97,216,2.57,12176
"5398",91337,2016,0,0,0,0,8
"5399",91340,2016,669,199,470,4.62,14467
"5400",91341,2016,0,0,0,0,103
"5401",91342,2016,297,23,274,1.3,22798
"5402",91343,2016,232,34,198,2.33,9952
"5403",91344,2016,366,23,343,3.6,10179
"5404",91345,2016,256,0,256,4.54,5644
"5405",91346,2016,0,0,0,0,2360
"5406",91350,2016,599,43,556,6.1,9827
"5407",91351,2016,473,146,327,6.08,7781
"5408",91352,2016,590,187,403,3.03,19484
"5409",91353,2016,0,0,0,0,166
"5410",91354,2016,146,17,129,7.39,1975
"5411",91355,2016,3989,678,3311,7.5,53206
"5412",91356,2016,1287,233,1054,9.61,13386
"5413",91357,2016,0,0,0,0,233
"5414",91361,2016,2358,210,2148,15.85,14874
"5415",91362,2016,2298,332,1966,10.75,21378
"5416",91364,2016,1878,275,1603,10.18,18443
"5417",91365,2016,0,0,0,0,284
"5418",91367,2016,5586,819,4767,14.38,38837
"5419",91372,2016,0,0,0,0,11
"5420",91376,2016,0,0,0,0,33
"5421",91380,2016,0,0,0,0,149
"5422",91381,2016,208,29,179,4.37,4764
"5423",91382,2016,0,0,0,NA,0
"5424",91383,2016,0,0,0,NA,0
"5425",91384,2016,77,6,71,3.51,2194
"5426",91385,2016,0,0,0,NA,0
"5427",91386,2016,0,0,0,0,21
"5428",91387,2016,150,10,140,6.11,2457
"5429",91390,2016,130,17,113,9.07,1433
"5430",91392,2016,0,0,0,0,263
"5431",91393,2016,0,0,0,0,102
"5432",91394,2016,0,0,0,0,11
"5433",91395,2016,0,0,0,0,3
"5434",91401,2016,407,101,306,4.17,9760
"5435",91402,2016,191,85,106,1.35,14123
"5436",91403,2016,2987,816,2171,20.33,14689
"5437",91404,2016,0,0,0,0,16
"5438",91405,2016,1058,930,128,6.49,16291
"5439",91406,2016,1576,548,1028,5.81,27149
"5440",91407,2016,0,0,0,NA,0
"5441",91408,2016,0,0,0,0,86
"5442",91409,2016,0,0,0,0,473
"5443",91410,2016,0,0,0,NA,0
"5444",91411,2016,865,0,865,9.05,9555
"5445",91412,2016,0,0,0,0,137
"5446",91413,2016,0,0,0,0,101
"5447",91416,2016,0,0,0,0,18
"5448",91423,2016,1270,264,1006,10.97,11576
"5449",91426,2016,0,0,0,0,11
"5450",91436,2016,4928,1205,3723,27.3,18049
"5451",91501,2016,98,44,54,4.27,2297
"5452",91502,2016,7322,5972,1350,29.3,24986
"5453",91503,2016,0,0,0,0,301
"5454",91504,2016,72628,70693,1935,83.9,86566
"5455",91505,2016,12922,6605,6317,40.85,31634
"5456",91506,2016,1630,552,1078,10.05,16211
"5457",91507,2016,0,0,0,NA,0
"5458",91510,2016,0,0,0,0,686
"5459",91521,2016,6956,5932,1024,76.09,9142
"5460",91522,2016,0,0,0,0,2539
"5461",91523,2016,0,0,0,0,881
"5462",91601,2016,1683,1100,583,15.96,10544
"5463",91602,2016,728,323,405,13.11,5554
"5464",91603,2016,0,0,0,0,188
"5465",91604,2016,1959,941,1018,15.59,12569
"5466",91605,2016,429,119,310,2.44,17599
"5467",91606,2016,606,138,468,6.87,8818
"5468",91607,2016,723,407,316,13.61,5314
"5469",91608,2016,14050,13895,155,82.25,17082
"5470",91609,2016,0,0,0,0,13
"5471",91610,2016,0,0,0,0,45
"5472",91614,2016,0,0,0,0,26
"5473",91615,2016,0,0,0,NA,0
"5474",91617,2016,0,0,0,NA,0
"5475",91702,2016,487,136,351,2.84,17159
"5476",91706,2016,1179,621,558,3.42,34427
"5477",91709,2016,451,0,451,3.24,13922
"5478",91710,2016,1362,147,1215,3.01,45296
"5479",91711,2016,910,39,871,6.18,14731
"5480",91714,2016,0,0,0,NA,0
"5481",91715,2016,0,0,0,0,1328
"5482",91716,2016,0,0,0,0,1170
"5483",91722,2016,197,0,197,2.44,8061
"5484",91723,2016,319,92,227,3.94,8087
"5485",91724,2016,444,0,444,6.25,7101
"5486",91731,2016,684,238,446,3.61,18922
"5487",91732,2016,173,46,127,2.55,6792
"5488",91733,2016,473,0,473,2.39,19824
"5489",91734,2016,0,0,0,0,889
"5490",91740,2016,1096,85,1011,9.23,11874
"5491",91741,2016,210,4,206,4.02,5219
"5492",91744,2016,353,91,262,2.65,13310
"5493",91745,2016,792,233,559,4.95,16006
"5494",91746,2016,640,161,479,3.38,18950
"5495",91747,2016,0,0,0,0,491
"5496",91748,2016,1242,336,906,3.95,31430
"5497",91749,2016,0,0,0,0,617
"5498",91750,2016,469,88,381,3.99,11755
"5499",91754,2016,1513,260,1253,6.96,21736
"5500",91755,2016,206,6,200,4.59,4490
"5501",91759,2016,0,0,0,0,92
"5502",91765,2016,1258,50,1208,8.02,15684
"5503",91766,2016,607,354,253,3.77,16080
"5504",91767,2016,305,0,305,2.31,13216
"5505",91768,2016,404,0,404,2.09,19340
"5506",91769,2016,0,0,0,0,1418
"5507",91770,2016,434,88,346,2.52,17192
"5508",91773,2016,2397,1490,907,11.87,20192
"5509",91775,2016,121,6,115,3.95,3061
"5510",91776,2016,1017,91,926,8.21,12390
"5511",91778,2016,0,0,0,0,1009
"5512",91780,2016,202,33,169,3.25,6216
"5513",91788,2016,0,0,0,0,266
"5514",91789,2016,1145,105,1040,4.93,23211
"5515",91790,2016,567,205,362,3.87,14640
"5516",91791,2016,257,0,257,2.73,9409
"5517",91792,2016,172,0,172,4.5,3826
"5518",91793,2016,0,0,0,0,74
"5519",91801,2016,867,164,703,5.3,16355
"5520",91802,2016,0,0,0,0,439
"5521",91803,2016,310,24,286,3.4,9109
"5522",92397,2016,9,0,9,1.76,511
"5523",92821,2016,2728,392,2336,6.65,41017
"5524",92823,2016,179,0,179,4.98,3591
"5525",93243,2016,0,0,0,0,2216
"5526",93510,2016,34,0,34,1.77,1926
"5527",93523,2016,315,0,315,44.68,705
"5528",93532,2016,0,0,0,0,2134
"5529",93534,2016,1122,100,1022,4.47,25116
"5530",93535,2016,218,82,136,2.16,10111
"5531",93536,2016,131,0,131,1.19,11011
"5532",93539,2016,0,0,0,0,56
"5533",93543,2016,0,0,0,0,836
"5534",93544,2016,0,0,0,0,133
"5535",93550,2016,740,212,528,4.67,15834
"5536",93551,2016,682,281,401,5.15,13234
"5537",93552,2016,10,10,0,0.32,3129
"5538",93553,2016,0,0,0,0,440
"5539",93560,2016,37,3,34,2.26,1635
"5540",93563,2016,0,0,0,0,40
"5541",93584,2016,0,0,0,0,50
"5542",93586,2016,0,0,0,NA,0
"5543",93590,2016,0,0,0,0,173
"5544",93591,2016,0,0,0,0,522
"5545",90001,2017,96,19,77,1.03,9334
"5546",90002,2017,5,0,5,0.15,3320
"5547",90003,2017,33,0,33,0.49,6720
"5548",90004,2017,784,224,560,7.61,10296
"5549",90005,2017,606,279,327,8.88,6824
"5550",90006,2017,409,77,332,4.25,9616
"5551",90007,2017,311,71,240,2.12,14679
"5552",90008,2017,147,111,36,2.28,6436
"5553",90009,2017,0,0,0,0,7036
"5554",90010,2017,5419,860,4559,17.83,30392
"5555",90011,2017,92,0,92,0.81,11296
"5556",90012,2017,3481,2673,808,2.11,164826
"5557",90013,2017,2107,298,1809,10.81,19485
"5558",90014,2017,1652,51,1601,12.31,13417
"5559",90015,2017,1788,633,1155,4.75,37659
"5560",90016,2017,1400,760,640,13.06,10722
"5561",90017,2017,15567,1693,13874,23.67,65766
"5562",90018,2017,116,9,107,2.11,5487
"5563",90019,2017,384,49,335,4.29,8961
"5564",90020,2017,141,0,141,0.91,15441
"5565",90021,2017,984,0,984,3.39,29036
"5566",90022,2017,417,226,191,2.15,19371
"5567",90023,2017,541,76,465,2.84,19028
"5568",90024,2017,4100,1073,3027,8.57,47867
"5569",90025,2017,8831,3174,5657,24.77,35657
"5570",90026,2017,513,127,386,5.01,10240
"5571",90027,2017,2247,1708,539,8.43,26661
"5572",90028,2017,8345,5558,2787,25.06,33301
"5573",90029,2017,141,53,88,1.89,7478
"5574",90030,2017,0,0,0,0,236
"5575",90031,2017,397,83,314,3.7,10721
"5576",90032,2017,3,3,0,0.03,10450
"5577",90033,2017,383,50,333,1.87,20474
"5578",90034,2017,1417,594,823,11.69,12118
"5579",90035,2017,3421,3034,387,28.2,12130
"5580",90036,2017,6595,3799,2796,21.46,30732
"5581",90037,2017,38,0,38,0.38,10085
"5582",90038,2017,5240,3894,1346,37.83,13850
"5583",90039,2017,432,137,295,4.38,9855
"5584",90040,2017,2459,223,2236,5.32,46252
"5585",90041,2017,507,171,336,5.82,8704
"5586",90042,2017,165,50,115,3.05,5408
"5587",90043,2017,40,14,26,0.61,6562
"5588",90044,2017,0,0,0,0,6916
"5589",90045,2017,4539,2072,2467,5.8,78318
"5590",90046,2017,2216,983,1233,11.83,18734
"5591",90047,2017,97,10,87,1.59,6091
"5592",90048,2017,3235,578,2657,8.97,36081
"5593",90049,2017,4724,3424,1300,23.94,19731
"5594",90050,2017,0,0,0,0,33
"5595",90051,2017,0,0,0,0,110
"5596",90052,2017,0,0,0,0,3139
"5597",90053,2017,0,0,0,NA,0
"5598",90054,2017,0,0,0,0,166
"5599",90055,2017,0,0,0,0,6
"5600",90056,2017,80,80,0,3.21,2491
"5601",90057,2017,507,99,408,4.53,11203
"5602",90058,2017,34,34,0,0.09,38047
"5603",90059,2017,0,0,0,0,4615
"5604",90060,2017,0,0,0,0,47
"5605",90061,2017,255,0,255,3.58,7126
"5606",90062,2017,7,4,3,0.23,3106
"5607",90063,2017,90,0,90,1.63,5517
"5608",90064,2017,10638,6178,4460,39.41,26993
"5609",90065,2017,769,232,537,8.1,9492
"5610",90066,2017,4933,1461,3472,31.28,15772
"5611",90067,2017,12283,2740,9543,40.46,30360
"5612",90068,2017,1134,657,477,18.2,6230
"5613",90069,2017,2946,1037,1909,13.52,21789
"5614",90070,2017,0,0,0,0,15
"5615",90071,2017,12650,0,12650,36.16,34985
"5616",90072,2017,0,0,0,0,1
"5617",90073,2017,0,0,0,0,4523
"5618",90075,2017,0,0,0,0,4
"5619",90076,2017,0,0,0,0,2
"5620",90077,2017,108,0,108,4.35,2483
"5621",90078,2017,5,0,5,14.71,34
"5622",90079,2017,138,38,100,13.84,997
"5623",90080,2017,0,0,0,0,1
"5624",90081,2017,0,0,0,0,27
"5625",90082,2017,0,0,0,0,3
"5626",90083,2017,0,0,0,NA,0
"5627",90086,2017,0,0,0,0,844
"5628",90087,2017,0,0,0,0,5
"5629",90089,2017,4,0,4,0.02,19307
"5630",90091,2017,0,0,0,0,7
"5631",90093,2017,3,0,3,3.12,96
"5632",90094,2017,3300,1136,2164,57.84,5705
"5633",90095,2017,73,0,73,0.68,10810
"5634",90201,2017,327,128,199,1.87,17496
"5635",90202,2017,0,0,0,0,56
"5636",90209,2017,14,11,3,7.87,178
"5637",90210,2017,3229,634,2595,13.67,23615
"5638",90211,2017,2054,642,1412,16.08,12777
"5639",90212,2017,2875,506,2369,17.51,16418
"5640",90213,2017,0,0,0,0,207
"5641",90220,2017,803,0,803,2.52,31923
"5642",90221,2017,77,0,77,0.51,15161
"5643",90222,2017,0,0,0,0,3204
"5644",90223,2017,0,0,0,0,2
"5645",90224,2017,0,0,0,0,150
"5646",90230,2017,4702,3017,1685,13.99,33617
"5647",90231,2017,0,0,0,0,3668
"5648",90232,2017,8379,4771,3608,38.22,21923
"5649",90233,2017,0,0,0,0,5
"5650",90239,2017,0,0,0,0,158
"5651",90240,2017,165,21,144,2.9,5684
"5652",90241,2017,548,260,288,2.48,22117
"5653",90242,2017,347,136,211,2.43,14251
"5654",90245,2017,16699,5273,11426,25.97,64305
"5655",90247,2017,346,180,166,2.48,13956
"5656",90248,2017,1883,0,1883,5.51,34180
"5657",90249,2017,100,0,100,0.92,10837
"5658",90250,2017,593,130,463,2.4,24747
"5659",90251,2017,0,0,0,0,88
"5660",90254,2017,1020,531,489,12.74,8007
"5661",90255,2017,325,90,235,2.2,14752
"5662",90260,2017,260,2,258,4.04,6432
"5663",90261,2017,8,0,8,0.59,1346
"5664",90262,2017,193,34,159,1.74,11115
"5665",90263,2017,0,0,0,0,1603
"5666",90264,2017,0,0,0,0,35
"5667",90265,2017,1262,279,983,15.06,8378
"5668",90266,2017,2416,437,1979,13.59,17780
"5669",90267,2017,14,0,14,12.84,109
"5670",90270,2017,15,0,15,0.35,4286
"5671",90272,2017,459,100,359,10.2,4498
"5672",90274,2017,1086,170,916,13.67,7942
"5673",90275,2017,448,6,442,7.96,5630
"5674",90277,2017,860,120,740,7.39,11632
"5675",90278,2017,1278,231,1047,9.16,13950
"5676",90280,2017,697,88,609,2.96,23566
"5677",90290,2017,91,39,52,10.73,848
"5678",90291,2017,6130,4585,1545,38.89,15762
"5679",90292,2017,2591,544,2047,17.87,14497
"5680",90293,2017,280,23,257,19.09,1467
"5681",90294,2017,0,0,0,0,22
"5682",90295,2017,10,0,10,38.46,26
"5683",90296,2017,0,0,0,0,35
"5684",90301,2017,339,126,213,2.26,15025
"5685",90302,2017,108,0,108,2.16,5001
"5686",90303,2017,61,0,61,0.98,6229
"5687",90304,2017,21,0,21,0.55,3804
"5688",90305,2017,15,0,15,1.4,1073
"5689",90306,2017,0,0,0,0,27
"5690",90307,2017,0,0,0,0,9
"5691",90308,2017,0,0,0,0,42
"5692",90309,2017,0,0,0,0,1
"5693",90310,2017,0,0,0,0,139
"5694",90311,2017,0,0,0,0,7
"5695",90312,2017,0,0,0,0,40
"5696",90401,2017,6898,2900,3998,22.91,30108
"5697",90402,2017,270,124,146,15.73,1717
"5698",90403,2017,1089,157,932,11.65,9347
"5699",90404,2017,13764,8751,5013,43.98,31296
"5700",90405,2017,4445,1520,2925,23.72,18740
"5701",90406,2017,0,0,0,0,149
"5702",90407,2017,0,0,0,0,4
"5703",90408,2017,0,0,0,0,8
"5704",90409,2017,0,0,0,0,20
"5705",90410,2017,0,0,0,0,52
"5706",90501,2017,2680,289,2391,9.93,26989
"5707",90502,2017,1626,0,1626,10.29,15805
"5708",90503,2017,2462,657,1805,7.34,33522
"5709",90504,2017,509,119,390,5.78,8807
"5710",90505,2017,2445,131,2314,7.96,30706
"5711",90506,2017,0,0,0,0,1904
"5712",90507,2017,0,0,0,0,76
"5713",90508,2017,0,0,0,0,1
"5714",90509,2017,88,0,88,3.23,2722
"5715",90510,2017,0,0,0,0,59
"5716",90601,2017,150,0,150,1.07,14003
"5717",90602,2017,152,0,152,1.55,9827
"5718",90603,2017,109,0,109,2.31,4724
"5719",90604,2017,18,0,18,0.63,2846
"5720",90605,2017,142,6,136,1.65,8623
"5721",90606,2017,107,0,107,1.7,6304
"5722",90607,2017,0,0,0,0,159
"5723",90608,2017,0,0,0,0,2355
"5724",90609,2017,0,0,0,0,18
"5725",90610,2017,0,0,0,0,18
"5726",90623,2017,614,0,614,8.79,6984
"5727",90630,2017,2661,855,1806,11.66,22814
"5728",90631,2017,370,66,304,2.12,17438
"5729",90637,2017,0,0,0,0,132
"5730",90638,2017,606,77,529,3.78,16012
"5731",90639,2017,0,0,0,0,1735
"5732",90640,2017,486,76,410,2.1,23140
"5733",90650,2017,654,126,528,2.69,24342
"5734",90651,2017,0,0,0,0,117
"5735",90652,2017,0,0,0,0,34
"5736",90660,2017,324,83,241,1.95,16656
"5737",90661,2017,0,0,0,0,2
"5738",90662,2017,0,0,0,0,49
"5739",90670,2017,1497,188,1309,2.82,53033
"5740",90671,2017,0,0,0,0,1
"5741",90701,2017,151,0,151,1.57,9600
"5742",90702,2017,0,0,0,0,453
"5743",90703,2017,2230,1032,1198,6.3,35371
"5744",90704,2017,0,0,0,0,2592
"5745",90706,2017,291,0,291,1.68,17291
"5746",90707,2017,0,0,0,0,83
"5747",90710,2017,222,23,199,2.88,7698
"5748",90711,2017,0,0,0,0,32
"5749",90712,2017,348,136,212,2.97,11730
"5750",90713,2017,120,0,120,3.01,3988
"5751",90714,2017,0,0,0,0,757
"5752",90715,2017,45,0,45,3.57,1260
"5753",90716,2017,22,0,22,0.56,3906
"5754",90717,2017,142,11,131,3.53,4017
"5755",90723,2017,450,54,396,2.54,17698
"5756",90731,2017,538,97,441,4.63,11617
"5757",90732,2017,143,8,135,4.39,3256
"5758",90733,2017,19,0,19,35.85,53
"5759",90734,2017,0,0,0,0,19
"5760",90744,2017,263,86,177,2.13,12363
"5761",90745,2017,516,25,491,3.48,14831
"5762",90746,2017,910,84,826,5.14,17693
"5763",90747,2017,0,0,0,0,2926
"5764",90748,2017,0,0,0,0,588
"5765",90749,2017,36,0,36,2.66,1351
"5766",90755,2017,714,40,674,5.87,12163
"5767",90801,2017,55,0,55,8.96,614
"5768",90802,2017,2808,359,2449,8.59,32683
"5769",90803,2017,1086,119,967,11.2,9700
"5770",90804,2017,519,0,519,5.53,9387
"5771",90805,2017,175,0,175,1.17,14942
"5772",90806,2017,1189,0,1189,5.34,22251
"5773",90807,2017,1083,0,1083,8.32,13017
"5774",90808,2017,830,249,581,6.9,12028
"5775",90809,2017,0,0,0,0,168
"5776",90810,2017,1165,279,886,7.49,15545
"5777",90813,2017,466,0,466,3.62,12869
"5778",90814,2017,76,2,74,3.36,2260
"5779",90815,2017,1046,318,728,7.37,14186
"5780",90822,2017,0,0,0,0,3400
"5781",90831,2017,200,0,200,15.8,1266
"5782",90840,2017,0,0,0,0,6037
"5783",90846,2017,0,0,0,0,1487
"5784",90853,2017,0,0,0,0,12
"5785",91001,2017,434,54,380,9.93,4370
"5786",91003,2017,0,0,0,0,102
"5787",91006,2017,1116,60,1056,8.08,13805
"5788",91007,2017,451,93,358,3.34,13495
"5789",91008,2017,0,0,0,0,87
"5790",91009,2017,0,0,0,0,24
"5791",91010,2017,130,8,122,0.91,14313
"5792",91011,2017,275,85,190,4.67,5887
"5793",91012,2017,0,0,0,0,20
"5794",91016,2017,2426,204,2222,13.26,18301
"5795",91017,2017,9,0,9,3.31,272
"5796",91020,2017,265,0,265,9.09,2914
"5797",91021,2017,0,0,0,0,33
"5798",91024,2017,82,14,68,3.2,2559
"5799",91025,2017,19,0,19,61.29,31
"5800",91030,2017,810,97,713,11.33,7149
"5801",91031,2017,0,0,0,0,51
"5802",91040,2017,113,0,113,3.65,3092
"5803",91041,2017,0,0,0,0,57
"5804",91042,2017,256,67,189,5.69,4497
"5805",91043,2017,0,0,0,0,36
"5806",91046,2017,0,0,0,0,69
"5807",91066,2017,0,0,0,0,74
"5808",91077,2017,2,0,2,9.52,21
"5809",91101,2017,4872,1043,3829,19.42,25084
"5810",91102,2017,0,0,0,0,159
"5811",91103,2017,2191,1270,921,20.04,10931
"5812",91104,2017,322,39,283,5.42,5938
"5813",91105,2017,2101,804,1297,10.61,19807
"5814",91106,2017,704,140,564,8,8805
"5815",91107,2017,1643,104,1539,8.36,19646
"5816",91108,2017,290,0,290,8.2,3535
"5817",91109,2017,0,0,0,0,9571
"5818",91114,2017,0,0,0,0,8
"5819",91115,2017,0,0,0,0,6
"5820",91116,2017,0,0,0,0,27
"5821",91117,2017,0,0,0,0,10
"5822",91118,2017,0,0,0,0,19
"5823",91125,2017,0,0,0,0,95
"5824",91126,2017,0,0,0,NA,0
"5825",91201,2017,866,369,497,5.53,15665
"5826",91202,2017,417,16,401,6.99,5968
"5827",91203,2017,4006,438,3568,17.05,23498
"5828",91204,2017,711,96,615,4.49,15845
"5829",91205,2017,706,189,517,5.78,12225
"5830",91206,2017,310,28,282,2.38,13027
"5831",91207,2017,117,25,92,8.42,1389
"5832",91208,2017,298,13,285,6.56,4543
"5833",91209,2017,11,0,11,1.04,1057
"5834",91210,2017,284,113,171,5.07,5607
"5835",91214,2017,322,17,305,6.34,5080
"5836",91221,2017,0,0,0,0,209
"5837",91222,2017,0,0,0,0,21
"5838",91224,2017,0,0,0,0,27
"5839",91225,2017,0,0,0,0,30
"5840",91226,2017,0,0,0,0,20
"5841",91301,2017,2599,476,2123,18.8,13824
"5842",91302,2017,3069,600,2469,17.37,17671
"5843",91303,2017,630,151,479,4.89,12888
"5844",91304,2017,907,302,605,6.58,13780
"5845",91305,2017,0,0,0,0,194
"5846",91306,2017,105,0,105,1.92,5462
"5847",91307,2017,293,111,182,4.03,7273
"5848",91308,2017,22,0,22,25.29,87
"5849",91309,2017,0,0,0,0,17
"5850",91310,2017,0,0,0,0,222
"5851",91311,2017,2546,887,1659,7.09,35907
"5852",91313,2017,0,0,0,0,389
"5853",91316,2017,974,132,842,10.07,9676
"5854",91321,2017,461,177,284,5.22,8827
"5855",91322,2017,0,0,0,0,372
"5856",91324,2017,786,138,648,4.17,18841
"5857",91325,2017,225,54,171,1.97,11403
"5858",91326,2017,241,42,199,5.64,4271
"5859",91327,2017,9,0,9,18,50
"5860",91328,2017,0,0,0,0,1920
"5861",91330,2017,0,0,0,0,7080
"5862",91331,2017,398,175,223,2.79,14248
"5863",91333,2017,0,0,0,0,4
"5864",91334,2017,0,0,0,0,15
"5865",91335,2017,200,0,200,1.53,13033
"5866",91337,2017,0,0,0,0,20
"5867",91340,2017,617,154,463,4.21,14644
"5868",91341,2017,0,0,0,0,150
"5869",91342,2017,309,28,281,1.29,23929
"5870",91343,2017,244,41,203,2.5,9767
"5871",91344,2017,419,28,391,3.89,10771
"5872",91345,2017,269,9,260,4.29,6276
"5873",91346,2017,0,0,0,0,2473
"5874",91350,2017,465,51,414,4.35,10679
"5875",91351,2017,450,163,287,5.37,8378
"5876",91352,2017,467,53,414,2.39,19578
"5877",91353,2017,0,0,0,0,195
"5878",91354,2017,222,25,197,10.55,2105
"5879",91355,2017,4064,574,3490,7.2,56410
"5880",91356,2017,1132,145,987,8.38,13513
"5881",91357,2017,24,0,24,8.7,276
"5882",91361,2017,2374,214,2160,15.5,15320
"5883",91362,2017,2319,257,2062,10.82,21433
"5884",91364,2017,1949,278,1671,10.67,18258
"5885",91365,2017,0,0,0,0,261
"5886",91367,2017,6217,919,5298,15.35,40491
"5887",91372,2017,0,0,0,0,71
"5888",91376,2017,2,0,2,2.47,81
"5889",91380,2017,0,0,0,0,257
"5890",91381,2017,265,27,238,5.56,4765
"5891",91382,2017,0,0,0,0,19
"5892",91383,2017,0,0,0,0,1183
"5893",91384,2017,82,5,77,3.68,2227
"5894",91385,2017,0,0,0,0,10
"5895",91386,2017,0,0,0,0,38
"5896",91387,2017,122,8,114,4.75,2569
"5897",91390,2017,134,24,110,8.83,1518
"5898",91392,2017,0,0,0,0,276
"5899",91393,2017,0,0,0,0,102
"5900",91394,2017,0,0,0,0,30
"5901",91395,2017,0,0,0,0,5
"5902",91396,2017,0,0,0,0,4
"5903",91401,2017,416,104,312,4.17,9984
"5904",91402,2017,218,87,131,1.45,14984
"5905",91403,2017,2951,813,2138,19.43,15186
"5906",91404,2017,0,0,0,0,32
"5907",91405,2017,1086,946,140,6.48,16769
"5908",91406,2017,1559,581,978,5.57,27969
"5909",91407,2017,0,0,0,0,90
"5910",91408,2017,0,0,0,0,64
"5911",91409,2017,4,0,4,0.84,475
"5912",91410,2017,0,0,0,0,82
"5913",91411,2017,1132,359,773,11.86,9547
"5914",91412,2017,0,0,0,0,151
"5915",91413,2017,15,0,15,8.67,173
"5916",91416,2017,4,0,4,13.79,29
"5917",91423,2017,1730,456,1274,13.84,12497
"5918",91426,2017,0,0,0,0,57
"5919",91436,2017,5469,1875,3594,29.18,18744
"5920",91501,2017,112,49,63,4.68,2392
"5921",91502,2017,2829,1701,1128,13.03,21706
"5922",91503,2017,16,0,16,5.86,273
"5923",91504,2017,67206,66341,865,82.08,81882
"5924",91505,2017,15032,7067,7965,43.74,34365
"5925",91506,2017,1280,411,869,8.84,14478
"5926",91507,2017,0,0,0,0,19
"5927",91510,2017,0,0,0,0,750
"5928",91521,2017,5929,5009,920,72.49,8179
"5929",91522,2017,0,0,0,0,2488
"5930",91523,2017,0,0,0,0,49
"5931",91601,2017,1625,872,753,15.02,10822
"5932",91602,2017,774,340,434,13.98,5535
"5933",91603,2017,0,0,0,0,175
"5934",91604,2017,1647,621,1026,13.28,12401
"5935",91605,2017,447,81,366,2.52,17704
"5936",91606,2017,630,134,496,7.45,8453
"5937",91607,2017,820,380,440,14.65,5599
"5938",91608,2017,14157,14012,145,83.17,17021
"5939",91609,2017,0,0,0,0,18
"5940",91610,2017,0,0,0,0,70
"5941",91614,2017,0,0,0,0,33
"5942",91615,2017,0,0,0,0,146
"5943",91616,2017,0,0,0,0,1
"5944",91617,2017,0,0,0,0,6
"5945",91702,2017,526,138,388,3.01,17455
"5946",91706,2017,1312,603,709,3.72,35289
"5947",91709,2017,474,0,474,3.14,15094
"5948",91710,2017,1424,89,1335,3.07,46378
"5949",91711,2017,838,38,800,5.62,14899
"5950",91714,2017,0,0,0,0,77
"5951",91715,2017,17,0,17,1.16,1464
"5952",91716,2017,0,0,0,0,1455
"5953",91722,2017,198,0,198,2.44,8112
"5954",91723,2017,364,91,273,4.51,8068
"5955",91724,2017,510,0,510,7.23,7052
"5956",91731,2017,644,216,428,3.36,19170
"5957",91732,2017,132,41,91,1.86,7079
"5958",91733,2017,533,51,482,2.63,20288
"5959",91734,2017,0,0,0,0,970
"5960",91740,2017,954,100,854,7.86,12143
"5961",91741,2017,237,14,223,4.29,5525
"5962",91744,2017,335,87,248,2.47,13548
"5963",91745,2017,829,255,574,4.96,16704
"5964",91746,2017,519,0,519,2.65,19574
"5965",91747,2017,0,0,0,0,472
"5966",91748,2017,1206,304,902,3.78,31908
"5967",91749,2017,0,0,0,0,628
"5968",91750,2017,437,70,367,3.59,12164
"5969",91754,2017,1564,252,1312,7.49,20868
"5970",91755,2017,171,4,167,3.71,4610
"5971",91759,2017,2,0,2,2.2,91
"5972",91765,2017,1328,53,1275,6.96,19081
"5973",91766,2017,705,401,304,4.22,16700
"5974",91767,2017,436,0,436,3.14,13900
"5975",91768,2017,355,0,355,1.81,19582
"5976",91769,2017,0,0,0,0,1265
"5977",91770,2017,441,93,348,2.46,17962
"5978",91773,2017,2408,1509,899,12.57,19159
"5979",91775,2017,105,9,96,3.42,3074
"5980",91776,2017,1108,91,1017,8.64,12821
"5981",91778,2017,0,0,0,0,992
"5982",91780,2017,222,36,186,3.59,6190
"5983",91788,2017,9,0,9,3.11,289
"5984",91789,2017,1123,117,1006,4.57,24563
"5985",91790,2017,636,208,428,4.24,14998
"5986",91791,2017,251,0,251,2.49,10070
"5987",91792,2017,173,0,173,4.07,4247
"5988",91793,2017,0,0,0,0,68
"5989",91801,2017,823,150,673,4.83,17035
"5990",91802,2017,8,0,8,1.77,453
"5991",91803,2017,335,47,288,3.55,9445
"5992",92397,2017,7,0,7,1.28,546
"5993",92821,2017,3010,354,2656,6.95,43284
"5994",92823,2017,162,0,162,4.82,3362
"5995",93243,2017,18,0,18,0.76,2374
"5996",93510,2017,39,0,39,2.73,1431
"5997",93523,2017,300,0,300,39.01,769
"5998",93532,2017,7,0,7,0.32,2181
"5999",93534,2017,1194,134,1060,4.56,26163
"6000",93535,2017,210,70,140,1.95,10793
"6001",93536,2017,138,0,138,1.27,10871
"6002",93539,2017,0,0,0,0,64
"6003",93543,2017,0,0,0,0,946
"6004",93544,2017,0,0,0,0,152
"6005",93550,2017,678,159,519,3.92,17290
"6006",93551,2017,682,286,396,4.71,14492
"6007",93552,2017,18,10,8,0.54,3349
"6008",93553,2017,0,0,0,0,450
"6009",93560,2017,41,0,41,2.39,1718
"6010",93563,2017,0,0,0,0,35
"6011",93584,2017,0,0,0,0,47
"6012",93586,2017,0,0,0,0,13
"6013",93590,2017,0,0,0,0,174
"6014",93591,2017,0,0,0,0,556
